абакир: абакиров
абакиров: абакировых
абдель: абдель
абдельджабер: абдельджабер
абдулай: абдулай
абир: абир
абсолютно: абсолютно
абсорбировать: абсорбируя
абсурд: абсурд
абьюзер: абьюзер абьюзеров
авария: аварии
август: августа августе
авиаудар: авиаудар авиаудара авиаударами авиаударах авиаударов авиаудару авиаудары
автобус: автобуса
автоколонна: автоколонн автоколонна автоколоннам автоколонне автоколонну автоколонны
автократический: автократическому
автомагистраль: автомагистралей
автономный: автономному
автор: авторов авторы
авторитет: авторитет
автостоянка: автостоянках
автотрансформатор: автотрансформаторов
агентство: агентств агентства агентствам агентствами агентстве агентство агентством агентству
агония: агонии
агрессия: агрессии
агрессор: агрессор агрессоры
ад: ада адом аду
адаптация: адаптации
адаптировать: адаптированы адаптировать
адван: адван
адвокат: адвокатам адвокатов адвокаты
адекватный: адекватного адекватной адекватный адекватным адекватных
адиль: адиль
адиля: адиля
административный: административные административный административным административных
администратор: администратор
администрация: администрация
администрирование: администрирование
адрес: адрес
адхан: адханом
адханом: адханома
аедерсон: аедерсон
ажигулов: ажигулова ажигуловой
азербайджан: азербайджан азербайджане
азия: азии азия
айсберг: айсберга
аккредитация: аккредитации
акт: акт актов акты
актив: активов
активизация: активизацией активизации активизация
активизировать: активизировали активизировать активизирует активизируют
активизм: активизм
активист: активист активистами активистов активисты
активно: активно
активность: активности
активный: активнее активного активное активные активных
актёр: актер
акула: акул
акунг: акунга
акция: акцией
акья: акьяа
алан: алан
александр: александра
алексей: алексей алексею алексея
алжир: алжир
алиса: алиса
алкоголизм: алкоголизм
аллергический: аллергическая
аллергия: аллергии аллергию аллергия
аллея: аллее
алматы: алматы
алсаатить: алсаати
альбанеза: альбанезе
альбенез: альбенезе
альрифай: альрифаи
альтернативный: альтернативный альтернативных
альхадж: альхадж
альянс: альянса
ама: ама
амазонка: амазонки
амбициозность: амбициозность
амбиция: амбиции
америка: америка америке америки америку
американский: американский американскому
амман: амман аммане
ампутация: ампутацию ампутациями
ампутированный: ампутированной ампутированными
ампутировать: ампутировали
анализ: анализ анализа анализу
анализировать: анализировать анализируем анализирует
аналог: аналогов
аналогичный: аналогичному аналогичный аналогичным аналогичных
анафилаксия: анафилаксия
андерсен: андерсен
андрей: андрей
анестезия: анестезии
анклав: анклав анклава анклаве анклаву
аномалия: аномалии
анонс: анонсы
антарктида: антарктида
антибиотик: антибиотиков
антивоенный: антивоенные антивоенный антивоенных
антисанитарный: антисанитарных
антисемитизм: антисемитизм антисемитизмом
антисемитский: антисемитской
антонелла: антонелла
антониу: антониу
антропогенный: антропогенные
аос: аос
апелляция: апелляцию
аплодисменты: аплодисменты
апокалиптический: апокалиптическая апокалиптические апокалиптической
аппарат: аппарату
аппетит: аппетита
апрель: апреле апреля
аптека: аптеку
арабский: арабские арабскими арабских арабского
аргумент: аргумента аргументов
ардаманта: ардаманте
ардамат: ардамате
ареал: ареала ареалу
арендовать: арендовать
арест: арест ареста аресты
арестовать: арестовали арестованных арестованы
арзакан: арзакан
ариф: ариф
армейский: армейские
армения: армения
армия: армией армии армия
арсенал: арсенала
артиллерия: артиллерией артиллерии
артобстрел: артобстрелов
артур: артур
архив: архива
архитектура: архитектуру
аспект: аспекта
ассамблея: ассамблеи ассамблея
ассанж: ассанж ассанжа
ассоциация: ассоциации
астана: астане
атака: атак атака атакам атаками атаках атаки атакой атаку
атаковать: атакован
атеф: атефа
атмосфера: атмосфера атмосферу
атомный: атомной атомных
ауа: ауа
аудиовизуальный: аудиовизуальные
аудиотека: аудиотека
аудитория: аудитории
аутизм: аутизм аутизма аутизмом
афганец: афганцам афганцев афганцы
афганистан: афганистан афганистана афганистане
афганский: афганские афганских афганской
африка: африка африке африки африкой
африканский: африканский африканского африканской
ахим: ахим
ахмаджон: ахмаджон
ахмед: ахмед
ашдод: ашдод ашдода
аэропорт: аэропорта
аэс: аэс
баба: баб
бавария: баварии
база: базы
базовый: базовую базовые базовым базовых
байя: байе
бактерия: бактерии
баланс: баланс
балда: балд
балл: балла
баллистический: баллистическими баллистических
банк: банк банка банком
банковский: банковские банковской
бапора: бапор
барс: барса
бассани: бассани
баталия: баталии
батарея: батарей
батиля: батили
бахус: бахус
бачегод: бачелет
бегство: бегством бегству
беда: беда беде
бедность: бедности
бедствие: бедствий бедствия бедствиями
бежать: бегут бежавшие бежавших бежал бежала бежали бежало бежать
беженец: беженцам беженцами беженцах беженцев беженцы
безвыходный: безвыходная
бездействие: бездействие
бездна: бездну
бездомный: бездомных
безжалостный: безжалостных
беззаконие: беззаконие
беззащитный: беззащитен беззащитные
безнадзорность: безнадзорности
безнадёжный: безнадежной
безнаказанно: безнаказанно
безнаказанность: безнаказанности безнаказанность
безнаказанный: безнаказанными
безоговорочно: безоговорочно
безоговорочный: безоговорочного безоговорочном безоговорочному безоговорочную
безопаность: безопаности
безопасно: безопасно
безопасность: безопасности безопасность безопасностью
безопасный: безопасна безопасная безопасного безопасное безопасной безопасному безопасную безопасные безопасный безопасным безопасными безопасных
безостановочный: безостановочных
безответственный: безответственная безответственным
безотлагательно: безотлагательно
безотлагательный: безотлагательные
безработица: безработица безработицы
безрецептурный: безрецептурные
безусловно: безусловно
безусловный: безусловное безусловному
безуспешно: безуспешно
бейрут: бейруте
беларусь: беларуси
белгород: белгород белгорода белгороду
белгородский: белгородской
белок: белка
белый: белый
бельё: белье белья
бензин: бензин
берег: берега берегов берегу
беременная: беременных
беременность: беременности
беременный: беременная беременные
беседа: беседы
бесконечно: бесконечно
бесконтрольный: бесконтрольный
беспилотник: беспилотники беспилотников
беспокоить: беспокоят
беспокоиться: беспокоясь
беспокойство: беспокойство
беспомощный: беспомощным
беспорядок: беспорядки
беспощадный: беспощадную беспощадны беспощадные
беспрепятственно: беспрепятственно
беспрепятственный: беспрепятственному беспрепятственную беспрепятственный
беспрерывно: беспрерывно
беспрерывный: беспрерывному
беспрецедентный: беспрецедентной беспрецедентном беспрецедентному беспрецедентную беспрецедентны беспрецедентные беспрецедентный беспрецедентным беспрецедентных
беспристрастный: беспристрастного беспристрастное
бессмысленный: бессмысленной бессмысленном бессмысленный
бесчеловечный: бесчеловечное бесчеловечные бесчеловечным
бесчисленный: бесчисленного бесчисленное
бетанкур: бетанкур
бик: бик
биологический: биологического биологическом
биоразнообразие: биоразнообразие биоразнообразием биоразнообразию биоразнообразия
битва: битву битвы
бить: бить бьет бьют
бишимбаев: бишимбаевым
благодарить: благодарим
благодарность: благодарность
благодарный: благодарны
благодаря: благодаря
благополучие: благополучие благополучием благополучии благополучия
благополучно: благополучно
благоприятный: благоприятной
благотворительный: благотворительный
ближневосточный: ближневосточного ближневосточное ближневосточному ближневосточный
ближний: ближнем ближнему ближний
близкие: близким
близкий: ближайшее ближайшем ближайшие ближе близка близкие близкими близких близкой
близлежащий: близлежащих
близость: близости близость
блогер: блогер
блокада: блокаде блокаду блокады
блокирование: блокированию
блокировать: блокировали блокирован блокировать
блокпост: блокпостов
бобовый: бобовые
бог: бога
богато: богато
богатый: богатое богатые богатыми
боевик: боевиками боевики боевиков
боевой: боевые боевым боевыми боевых
боеприпас: боеприпасами боеприпасов боеприпасы
боестолкновение: боестолкновений
бой: боев бои боях
бойня: бойню
бок: бок
болгария: болгарии
болезнь: болезней болезни болезнь болезням болезнями
болеть: болел
болото: болота
боль: боли боль
больница: больниц больница больницам больницах больнице больницу больницы
больничный: больничным больничных
больной: больные больным больных
больший: большая большего большее большей большему большие больший большим большую наибольшее наибольшей наибольшему наибольшую
большинство: большинстве большинство
большой: большого большое большой большом велики
бомба: бомб бомбы
бомбардировка: бомбардировкам бомбардировками бомбардировках бомбардировки бомбардировкой бомбардировок
бомбоубежище: бомбоубежища
бомбёжка: бомбежек
боннский: боннская
бороться: борется бороться борются
борт: борту
бортовый: бортовой
борьба: борьба борьбе борьбу борьбы
бояться: боимся боюсь боялись боялся боятся
бразилия: бразилия
брак: брак
брат: брат
брать: берет берут брал
браун: браун
брезент: брезент брезента
бремя: бременем бремя
бригада: бригады
британский: британские британском
брифинг: брифинг брифинга брифинге брифингов
бросать: бросать
бросаться: бросается бросаются
бросить: бросить брошенных
будущее: будущего будущее будущем будущим
будущий: будущая будущей будущему будущих
буквально: буквально
бульдозер: бульдозер
бункер: бункеров
бутилировать: бутилированная бутилированной бутилированную
буча: буче
бывать: бывает бывают
бывший: бывшего бывшем бывший бывшим бывшими бывших
быстро: быстро
быстрый: быстрая быстрее быстрого быстрое быстрой быстрому
быт: быту
бытовой: бытовое бытовым
быть: будем будут суть
бэкхёрстый: бэкхерст
бюро: бюро
вади: вади
важно: важно
важность: важность
важный: важна важная важнейшая важнейшее важнейшей важнейшие важнейшим важнейшими важнейших важнейшую важного важной важном важную важны важные важный важным важными важных
вакуум: вакууме
вакцина: вакцин вакцина вакцинами вакцине вакциной вакцину вакцины
вакцинация: вакцинации вакцинацию вакцинация
валленберг: валленберга
валовый: валовая
валюта: валюты
ван: ван
вариант: вариант
василий: василий
ваучер: ваучеры
ваш: ваша ваше вашего вашей вашему ваши вашим
вашингтон: вашингтон вашингтоне
вблизи: вблизи
введение: введение введения
ввезти: ввезено ввезены ввезти
вверить: вверенное
ввести: введен введена введенные введенным введенных введя ввел ввели ввести
вводить: вводит вводить
вводиться: вводится
ввоз: ввоз ввоза ввозу
ввозить: ввозить
ввп: ввп
вдвое: вдвое
вдоль: вдоль
вдохнуть: вдохнут
ведение: ведении ведения
ведро: ведра
ведущий: ведущим ведущих
везде: везде
век: века
велеть: велят
велик: велике
великобритания: великобританией великобритании великобританию великобритания
велосипед: велосипеде
венгрия: венгрии
веннесланда: веннесланд
верблюд: верблюд
вербовка: вербовке вербовки
вердикт: вердикт
верить: верю
вернуть: вернули вернуть
вернуться: вернитесь вернувшиеся вернувшийся вернувшимися вернувшимся вернувшись вернулась вернулись вернулся вернутся вернуться
веровать: верующий
вероятно: вероятно
вероятность: вероятность
вероятный: вероятен вероятных
версия: версии
вертолёт: вертолеты
верхний: верхней
верховенство: верховенства
верховный: верховного верховный
верхушка: верхушка
верёвка: веревки
вес: вес
весомый: весомый
вести: ведем ведет ведут вести
вестись: ведется велся
весь: весь всей всем всеми всему вся
весьма: весьма
ветер: ветра ветры
ветеран: ветераны
вето: вето
ветряный: ветряной
вечер: вечер
вечером: вечером
вещество: вещества
вещь: вещами вещи
взаимодействовать: взаимодействует
взаимоотношение: взаимоотношения
взаимопонимание: взаимопонимании
взаимосвязанный: взаимосвязанной взаимосвязанными
взамен: взамен
взгляд: взгляд взглядов взгляды
взнос: взнос
взрослый: взрослые взрослым взрослыми взрослых
взрыв: взрывов взрывы
взрывной: взрывного
взрывчатка: взрывчатки
взять: взял взяли взяло взяты взятые взять
вид: вид видам видами видах виде видов виду виды
видео: видео
видеоролик: видеоролике
видеосвязь: видеосвязи
видеосообщение: видеосообщении
видеть: видел видела видели видеть видим видите вижу
видно: видно
виднов: виднова
видный: видна видного видны
визит: визит визита
вина: вину
винница: винницы
вино: вина
виновный: виновен виновной виновные виновным виновных
винтовка: винтовки
вирус: вирус вирусом
вирусный: вирусная вирусное
висеть: висят
вишнёвый: вишневое
вклад: вклад вклады
включать: включает включала включают включающих
включая: включая
включить: включен включено включены включили включить
вконтакте: вконтакте
вкратце: вкратце
владимир: владимир владимира
власть: властей власти властям властями
влияние: влияние влиянием влиянию
влиять: влияет
вложить: вложенный
вместе: вместе
вместимость: вместимости вместимость
вмешательство: вмешательств вмешательствах
вмешиваться: вмешиваться
вне: вне
внедрение: внедрение
внезапный: внезапный
внеочередной: внеочередной
внесение: внесения
внести: внесенных
внесудебный: внесудебных
внешкольный: внешкольных
внешне: внешне
внешний: внешнего внешним внешними внешняя
внимание: внимание внимания
внимательно: внимательно
внимательный: внимательным
вновь: вновь
вносить: вносили вносит
внутренне: внутренне
внутренний: внутреннего внутренней внутренние внутренних внутреннюю
внутри: внутри
внутривенный: внутривенные внутривенных
внутрь: внутрь
вовлечение: вовлечению
вовлечь: вовлечен вовлеченное вовлеченным вовлеченных
вода: вод вода водами воде водой воду воды
водитель: водителей
водный: водные
водовоз: водовозов
водоочистный: водоочистных
водопровод: водопровод водопровода водопроводов
водопроводный: водопроводных
водоросль: водоросли
водоснабжение: водоснабжение водоснабжении водоснабжению водоснабжения
водяной: водяных
воевать: воюем воюют
военизированный: военизированной
военнопленный: военнопленные военнопленным военнопленными военнопленных
военнослужащий: военнослужащие военнослужащий военнослужащим военнослужащих
военный: военная военного военное военной военному военную военные военный военным военными военных
воз: воз
возбуждение: возбуждения
возвести: возведенные
возврат: возврат
возвращать: возвращают
возвращаться: возвращается возвращался возвращаются возвращающиеся возвращающимся возвращающихся
возвращенец: возвращенцев
возвращение: возвращение возвращения
возглавить: возглавил возглавит
возглавлять: возглавляемого возглавляет
воздействие: воздействие воздействия
воздержаться: воздержалась воздержались
воздерживаться: воздерживаться
воздух: воздух воздуха воздухе воздуху
воздушный: воздушного воздушной воздушные воздушных
возле: возле
возложить: возложены
возмещение: возмещении
возможно: возможно
возможность: возможностей возможности возможность возможностью возможностями
возможный: возможна возможного возможное возможной возможные возможным возможных
возмутительный: возмутительным
возмущать: возмущает
возмущение: возмущений
возникать: возникает возникают возникающими
возникновение: возникновения
возникнуть: возникла возникли
возобновить: возобновить возобновленных возобновлено
возобновиться: возобновились возобновиться возобновятся
возобновление: возобновление возобновлением возобновления
возобновлять: возобновляемые возобновляемых возобновляет возобновляют
возраст: возраста возрасте возрасту
возрастать: возрастает
возрасти: возрос возросли возросло возросшем
возращение: возращения
возродить: возродить
война: война войне войной войну войны
войско: войск войска войсками
войти: вошли
вокруг: вокруг
волна: волна волне волну волны
волонтерство: волонтерству
волонтёр: волонтер волонтеров
волос: волосам
волосок: волоске
воля: воле воли воля
вообще: вообще
вооружённый: вооруженного вооруженном вооруженному вооруженные вооруженным вооруженными вооруженных
воочию: воочию
вопиять: вопиющего вопиющем вопиющим
воплотить: воплотить
вопрос: вопрос вопроса вопросам вопросах вопросе вопросов вопросом вопросу вопросы
ворваться: ворвались
воронка: воронки
восемь: восемь восьми
воскресение: воскресенье
восорн: восорну
воспаление: воспалению
воспитание: воспитание воспитании
воспитывать: воспитывать воспитывают
воспользоваться: воспользовавшись воспользоваться
восприниматься: воспринимается
восприятие: восприятии
воссоединение: воссоединения
восстанавливать: восстанавливать восстанавливают
восстанавливаться: восстанавливается
восстановительный: восстановительных
восстановить: восстановили восстановить восстановлен восстановлены
восстановиться: восстановилась
восстановление: восстановление восстановлением восстановлении восстановлений восстановлению восстановления
восток: восток востоке востоком востоку
восторжествовать: восторжествовала
восточный: восточного восточной восточные восточный восточным
востребовать: востребованная
восьмилетний: восьмилетняя
восьмой: восьмой
вошь: вшами
впервые: впервые
впереди: впереди
вперёд: вперед
впитывать: впитывают
вполне: вполне
впоследствии: впоследствии
впп: впп
впредь: впредь
впускать: впускать
враждебность: враждебностью
врач: врач врача врачам врачей врачи врачом врачу
вред: вред вреда
вредитель: вредителей
вредный: вредных
временно: временно
временной: временная временного временное временной временном временному временные временным временными временных
временный: временный
время: времен времена временем времени время
врождённый: врожденные
вронецкий: вронецкая
вс: вс
всевозможный: всевозможных
всемирный: всемирная всемирного всемирной всемирном всемирный всемирным
всеобщий: всеобщее всеобщей
всеобъемлющий: всеобъемлющего всеобъемлющий
всесторонний: всестороннего всестороннюю
вскармливание: вскармливания
вскоре: вскоре
всплеск: всплеск всплеске
вспыхнуть: вспыхнувшем вспыхнувший вспыхнул вспыхнули
вспышка: вспышек вспышка вспышках вспышки вспышку
вспять: вспять
всс: всс
вставать: вставали
встать: встал
встревожить: встревожены
встретиться: встретилась встретился встретится встречусь
встреча: встреч встреча встречами встречах встрече встречи
встречать: встречали
встречаться: встречается встречались встречался встречаться встречаются
вступать: вступая
вступить: вступили вступило
вступление: вступление вступления
всякий: всяких
всячески: всячески
вторгнуться: вторглись
вторжение: вторжение вторжением вторжения
вторить: вторя
вторник: вторник
второй: вторая второго второй вторую
втянутый: втянутыми
вуд: вуд
вуля: вуль
входить: входили входят
входящий: входящей входящих
вчера: вчера
вчерашний: вчерашнего вчерашний
въезд: въезд въезда въезду
въезжать: въезжает въезжали въезжало въезжать
въехать: въехал въехали въехало
вы: вами
выбирать: выбирал выбирали
выбираться: выбирались
выбить: выбила выбито
выбор: выбор выбора выбору
выборочно: выборочно
выбрать: выберут
выбраться: выбраться
выброс: выбросами выбросов
вывезти: вывезенных вывезены вывезти
вывести: выведены вывели
вывод: выводу
вывоз: вывоз вывозе
выглядеть: выглядело
выгода: выгод
выдавать: выдавало
выдать: выдал выдано
выдвигать: выдвигала
выдвинуть: выдвинувших выдвинутые выдвинутыми выдвинутых
выделение: выделение
выделить: выделена выделено выделившая выделила выделили выделить
выживание: выживание выживания
выжить: выжившие выжил выжила выжить
вызвать: вызвали вызвана вызванного вызванное вызванные вызванных вызвано вызваны
выздороветь: выздороветь
вызов: вызов вызовам вызовами вызовов вызовы
вызывать: вызываемое вызывает вызывать вызывают
вызываться: вызывается
вызывающий: вызывающее вызывающих
выйти: выйти вышли
выкидыш: выкидыша
вылов: вылов
вымирание: вымирания
вымогательство: вымогательства вымогательствах вымогательстве
вымогать: вымогали
вынести: вынес
выносить: выносить вынося
вынудить: вынудила вынудили вынудило вынужден вынуждена вынуждено вынуждены
вынужденный: вынужденное вынужденном вынужденному вынужденные вынужденным вынужденными вынужденных
выплата: выплаты
выплатить: выплатить
выполнение: выполнение выполнения
выполнить: выполнены
выполнять: выполняет выполнял выполняли выполнять
выполняться: выполняются
выпустить: выпустить
выражать: выражало выражать выражают
выражение: выражение выражением выражения
выразить: выражены выразив выразил выразила выразили выразило выразить
вырасти: выросла выросли выросло
вырваться: вырваться
вырубаться: вырубаются
вырубка: вырубкой
выселение: выселении
высказаться: высказались
высказывание: высказывания
высказывать: высказывают
высокий: высока высокие высокий высоким высокими высоких высокого высокой высоком высокому высшего высшем высший высшим наивысший
высоко: высоко
высокопоставленный: высокопоставленные высокопоставленный высокопоставленными высокопоставленных
высокоэффективный: высокоэффективного
выставить: выставлен
выставка: выставка
выстраиваться: выстраиваются
выстроить: выстроить
выступать: выступал выступаю выступая
выступить: выступивший выступил выступила выступили
выступление: выступление выступлении выступления
высылка: высылку
вытеснить: вытеснили
выход: выхода
выходец: выходцами
выходить: выходит выходить выходящих
выходной: выходные
выше: выше
вышеупомянутый: вышеупомянутые
выявить: выявлено
выяснить: выяснить
гаага: гааге
гавирия: гавирия
газ: газ газа газом
газа: газе газой газу газы
газовый: газовых
газоснабжение: газоснабжение
гаити: гаити
галант: галанта
гарантировать: гарантирована гарантированного гарантировано гарантировать гарантирует
гарантия: гарантией гарантии гарантий
гартен: гартен
гвоздь: гвозди
гебрейесус: гебрейесус гебрейесуса
гезира: гезира
гейра: гейра
гектар: гектаров
генассамблея: генассамблее
гендерный: гендерного гендерное гендерном гендерному гендерных
генеральный: генерального генеральной генеральному генеральный генеральным
генератор: генераторах генераторов генераторы
геноцид: геноцид геноцида геноциде
геноцидальный: геноцидальное
генпрокуратура: генпрокуратуру
генсек: генсек генсека
географический: географическую
геополитический: геополитическими
гепатит: гепатитом
герат: герат
германия: германии германию
германский: германской
героизм: героизма героизму
герцог: герцогом
гетеросексуальный: гетеросексуальным гетеросексуальных
гибель: гибели гибель гибелью
гибнуть: гибнут гибнуть
гигант: гигантов
гигантский: гигантская
гигиена: гигиене гигиены
гигиенический: гигиенические
гидроэлектростанция: гидроэлектростанции
гилада: гилад
гиперзвуковой: гиперзвукового
гипс: гипсом
глава: глава главе главой главу главы
главное: главного главное
главный: главная главной главном главные главный главным главных
гладить: гладят
глаз: глаз глаза глазами глазах
глобальный: глобальная глобального глобальное глобальной глобальному глобальную глобальные глобальный глобальным глобальных
глотка: глотке
глубина: глубину глубины
глубокий: глубокие глубокую
глубоко: глубоко
глянуть: глянь
гнев: гнев
говорить: говорил говорила говорили говорит говорите говорить говоря говорят
говориться: говорится
год: год года годах годов годом году годы лет
годовалый: годовалой
годовщина: годовщину годовщины
голова: головой
головной: головная головного
голод: голод голода голоде голодом голоду
голодать: голодает голодают голодающее голодающими голодающих
голодный: голодная голодной голодны голодные голодных
голос: голос голоса
голосование: голосованием голосования
голубой: голубой голубые
гончарук: гончарук
гора: гор горе
гораздо: гораздо
горбатый: горбатые
гордиться: гордимся
гордость: гордостью
горе: горем горя
горизонт: горизонта
горинов: горинову
гориновый: горинов горинова
горло: горле
горловка: горловке
горный: горной горных
город: город города городам городах городе городов городу
городской: городских городской
горючее: горючего
горячий: горячее горячей горячие горячим горячих
госпитализация: госпитализации
госпиталь: госпитали
гостевой: гостевой
гостиница: гостинице
государственный: государственная государственные государственным государственных
государство: государств государства государствах государстве государство государством
госуслуга: госуслуг
готовить: готовил готовит готовить
готовиться: готовится готовятся
готовность: готовности
готовый: готов готова готового готовы
грабёж: грабежей
градус: градусов
гражданин: граждан граждане гражданина
гражданский: гражданская гражданские гражданский гражданским гражданских гражданского гражданское гражданской гражданскому гражданскую
гражданство: гражданства гражданство гражданством
грамотный: грамотным
гранди: гранди
граница: границ граница границах границе границей границу границы
грант: гранту
грань: грани грань
график: графиком
гриб: грибы
гриффитс: гриффитс гриффитса гриффитсом
гроза: гроза грозу грозы
грозить: грозит грозить грозят
громкий: громкие громкий
грубый: грубейший
грудной: грудного
грудь: груди
груз: груз грузами грузов грузы
грузия: грузии
грузовик: грузовик грузовика грузовикам грузовиках грузовики грузовиков
грузовой: грузовые грузовых
группа: групп группа группам группами группу группы
группировка: группировкам группировками группировки группировкой группировок
групповой: групповых
грустить: грустить
гсчс: гсчс
губка: губка
гулаг: гулага
гулить: гулить
гуманизм: гуманизма
гуманитарный: гуманитарная гуманитарного гуманитарное гуманитарной гуманитарном гуманитарному гуманитарную гуманитарные гуманитарный гуманитарным гуманитарными гуманитарных
гуманный: гуманном
гумкоординатор: гумкоординатора
гумпомощь: гумпомощи
густонаселённый: густонаселенного густонаселенном густонаселенный густонаселенным густонаселенных
гутерриша: гутерриш гутерриша
давать: давайте давал давали давать дает дают
давид: давид
давление: давление давлением давлению давления
давно: давно
давность: давности
давос: давосе
дагестан: дагестан дагестана
далеко: далеко
дальнейший: дальнейшего дальнейшее дальнейшей дальнейшем дальнейшему дальнейшим дальнейших дальнейшую
далёкий: далекую дальше подальше
данные: данным данных
данный: данного данную данный
дарить: дарим
даровать: дарует
дарфура: дарфур дарфура дарфуре
дарфурский: дарфурскими дарфурского
датский: датским
дать: дадут дал данная данные даст дать
два: две двум двумя двух
двадцатилетний: двадцатилетней
двадцать: двадцать
дважды: дважды
дверь: двери дверь дверью дверями
двигаться: двигаться движется
движение: движение
двое: двое двоих
двойной: двойным двойных
двор: дворах
дворец: дворце
двухмесячный: двухмесячный
двухмиллионный: двухмиллионное
дд: дд
де: де
дебатироваться: дебатировался
девочка: девочек девочка девочкам девочки
девушка: девушек девушка девушкам девушками девушке девушки девушкой девушку
девятилетний: девятилетний
девять: девяти девять
деградация: деградации деградация
деградировать: деградировавших деградируют
дежурить: дежурил
дезинформация: дезинформацией
действие: действие действий действия действиям действиями действиях
действительно: действительно
действовать: действовавших действовала действовали действовать действует действуют действующего действующей действующими
декабрь: декабре декабрь декабря
декларация: декларации декларацию
декриминализовать: декриминализовано
делать: делаем делает делала делали делать делают делающим делая
делегация: делегации делегация
делить: делил
делиться: делиться
дело: дел дела делам деле дело делу
демократический: демократической демократическому
демократия: демократии
демонстрировать: демонстрировал демонстрируют демонстрируя
денежный: денежной денежную денежные
дениз: дениз
денис: денис
день: день дне дней днем дни дня
деньга: денег деньги
департамент: департамент департамента
депортация: депортации депортацию
депортировать: депортировал
депрессивный: депрессивного
депрессия: депрессия
депутат: депутатом
деревня: деревень
держать: держали держат держать
держаться: держаться
дестабилизация: дестабилизации
десятилетие: десятилетие десятилетия десятилетиями
десятка: десяткам десятки
десяток: десятков
десятый: десятого
десять: десяти десять
детальный: детальные
детский: детские детский детским детских детского детское детской детском детскую
детство: детства детстве детство
дефицит: дефицит дефицитом
деэскалация: деэскалации
деятель: деятеля
деятельность: деятельности деятельность деятельностью
дж: дж
джабалии: джабалии
джабалий: джабалию джабалия
джабер: джабер
джаджаркот: джаджаркот
джанджавид: джанджавид
джеймс: джеймс
джейн: джейн
дженина: дженине
дженять: джейми
джилани: джилани
джилла: джилл
джоан: джоан
джонатан: джонатан
джонсон: джонсон джонсону
джубийский: джубийского
джулиан: джулиан джулиана
джульетта: джульетт
диабет: диабет
диагноз: диагноз
диализ: диализ диализе
диалог: диалог диалоге диалогу
диарейный: диарейных
диарея: диарее диареей диареи диарея
дизель: дизеля
дикарло: дикарло
дикий: дикий диких дикой
дима: димы
динамика: динамику
дипломат: дипломат дипломаты
дипломатический: дипломатические дипломатических
дипломатия: дипломатия
директива: директивой
директор: директор директора
дискриминация: дискриминацией дискриминации
дискуссия: дискуссиям дискуссиях
диссидент: диссиденты
дистанционный: дистанционной
дистанцироваться: дистанцируется
дисциплинарный: дисциплинарные
дисциплинировать: дисциплинировать
длинный: длинная длинной длинные
длительный: длительное длительной длительный длительным длительных
длиться: длилась длились длится длятся
днепр: днепр днепра днепре
днепровский: днепровского днепровской
днепропетровский: днепропетровской
дно: дна
добавить: добавив добавил добавила добавили
добавлять: добавляет
добиваться: добиваться
добираться: добираться
добиться: добившись добились добиться добьются
добраться: добраться
добро: добро
доброволец: добровольцы
добровольный: добровольное добровольных
добрый: добрая
доверие: доверие доверия
доверять: доверяют
довод: довод
довольно: довольно
довольный: довольны
договор: договор договора
договориться: договорились договориться
договорённость: договоренностей договоренности
доехать: доехали доехать
дождь: дождей дожди дождя
дожидаться: дожидаться
дожить: доживет
доза: доз дозами дозу дозы
доказательство: доказательство
доказать: доказано доказать
доказывать: доказывает
доклад: доклад доклада докладе докладом докладу
докладчик: докладчик докладчика докладчики
докладчица: докладчица
докризисный: докризисным
доктор: доктор доктора доктором
документ: документ документе документов документу документы
документировать: документировать документирует
долг: долг долгами долгом
долгий: долгая долгие долгое дольше
долгожданный: долгожданное долгожданный
долгосрочный: долгосрочного долгосрочное долгосрочной долгосрочному долгосрочную долгосрочные
должное: должное
должность: должности
должный: должен должна должно должного должны
доллар: доллар долларов
доля: долю доля
дом: дом дома домам домах доме домов домом дому
домашний: домашнего домашнее домашним
доминик: доминик
доминирование: доминирование
доминиса: доминис
доминисис: доминисис
доминичис: доминичис
домогательство: домогательствах
домой: домой
домохозяйство: домохозяйств
донецк: донецка донецке
донецкий: донецкая донецкой
донор: донорам донорами доноров доноры
донохью: донохью
дополнение: дополнение
дополнительно: дополнительно
дополнительный: дополнительная дополнительного дополнительной дополнительную дополнительные дополнительный дополнительных
допускать: допускать
допустить: допустить
доработать: доработать
дорога: дорог дорога дорогам дорогах дороги дорогой дорогу
дорожный: дорожную
досмотреть: досмотрена досмотрены
доставить: доставившие доставила доставили доставить доставлен доставлена доставлено доставлены
доставка: доставка доставке доставки доставку
доставлять: доставлявшая доставляемой доставляемый доставляет доставляло доставлять доставляют доставляя
доставляться: доставлялись
достаток: достатка
достаточно: достаточно
достаточный: достаточного достаточное достаточной достаточному достаточных
достать: достать
достигать: достигает достигало достигают
достигнутый: достигнутое достигнутые достигнутый достигнутым
достигнуть: достигла достигли достигло достигнем достигнет достичь
достижение: достижение достижении достижению достижения
достижимый: достижимый
достоверность: достоверности
достоверный: достоверные достоверных
достоинство: достоинство
достойный: достойное достойной достойных
достопримечательность: достопримечательностей
доступ: доступ доступа доступе доступом доступу
доступный: доступная доступного доступное доступны доступными
досягаемость: досягаемости
дотла: дотла
доутен: доутен
доход: дохода доходы
доходить: доходили доходит
дочка: дочки дочкой
дочь: дочери дочерью дочерям дочь
др: др
драгоценный: драгоценное
драматический: драматической
дрк: дрк
дрон: дронов дроны
друг: друг друга другом другу друзей друзьями
другой: другая другие другим другими других другого другое другую
дружба: дружбы
дружественный: дружественной
дср: дср
дуб: дубы
дубай: дубае
думать: думаешь думал думать думаю думают
дух: духа
душа: души душу
душевный: душевную
душераздирающий: душераздирающая душераздирающей душераздирающую
дыра: дыры
дыхание: дыхание
дэниел: дэниел дэниелу
дюжаррик: дюжаррик дюжаррика
дядька: дядек
дядя: дядя
евгений: евгения
еврей: евреев
еврейский: еврейскими еврейского еврейское еврейской
европа: европа европе европу европы
европеец: европейцев
европейский: европейская европейские европейский европейских европейского европейской европейском европейскую
евросоюз: евросоюза
египет: египет египта египте египтом
египетский: египетский египетского египетской египетскому
египтянин: египтянами
еда: еде едой еду еды
едва: едва
единица: единиц
единовременный: единовременная
единственный: единственная единственное единственной единственному единственный
ежегодно: ежегодно
ежегодный: ежегодная ежегодный
ежедневно: ежедневно
ежедневнов: ежедневнов
ежедневный: ежедневного ежедневное ежедневном ежедневные ежедневный ежедневным ежедневных
ежемесячно: ежемесячно
ежемесячный: ежемесячного
ежечасно: ежечасно
ездить: ездит ездить
ерден: ерден ердена
ес: ес
еспча: еспч
естественный: естественной
есть: едят ели
ехать: ехать
жажда: жажды
жако: жако
жалоба: жалоб жалобами
жаловаться: жалуюсь жалуются
ждать: ждали ждать ждем ждет ждут
жевание: жевании
желать: желают
железа: железой
желтуха: желтухой
жена: жен жена жене женой жену жены
женева: женеве
женевский: женевским
жениться: женился
женский: женские женских женского женское
женщина: женщин женщина женщинам женщинами женщине женщину женщины
жертва: жертв жертва жертвам жертвами жертвах жертвы
жест: жесты
жестокий: жестокие жестокий жестоким жестокими жестокого жестокое жестокой жестокому
жестокость: жестокости жестокость
жечь: жгли
живой: живого живой живы живых
живот: животе
животное: животные животными животных
жидкость: жидкостей жидкости
жизнедеятельность: жизнедеятельности
жизненно: жизненно
жизненный: жизненного
жизнеобеспечение: жизнеобеспечения
жизнестойкость: жизнестойкости
жизнь: жизней жизни жизнь жизнью жизнями
жилище: жилищах
жилищный: жилищного жилищном жилищные
жилой: жилого жилой жилому жилые жилым жилых
жильё: жилье жилью жилья
жираф: жирафы
житель: жителей жители житель жителя жителям жителями жителях
жительница: жительниц жительница жительницы
жительство: жительства
житница: житницей
жить: живем живет живут живущие живущих жил жила жить
жс: жс
журнал: журнал
журналист: журналист журналистам журналистами журналистов журналисты
жёлтый: желтую
жёсткий: жесткое жесткой
забеременеть: забеременеют
заблокировать: заблокирован заблокированные
заблуждение: заблуждение
заболеваемость: заболеваемости заболеваемость
заболевание: заболевание заболеваний заболевания заболеваниями
заболеть: заболевшим заболеет
забота: забота заботы
заботиться: заботиться
заботливый: заботливым
забрать: забрали забрать
забросить: заброшенные
забывать: забывает забывать забываю забывая
забыть: забудет забудут
завал: завалами завалов
заведение: заведений заведения
заверение: заверения
завершать: завершающем
завершение: завершения
завершить: завершивший завершила завершить
завершиться: завершилась завершились завершиться
зависеть: зависеть зависит зависят зависящие
зависть: зависти
заводить: заводить
завтрашний: завтрашнем
завязать: завязанными
заговор: заговор
загоут: загоут
загранпаспорт: загранпаспорт
загружать: загружайте загружать
загрузить: загруженные
загрузка: загрузке
загрязнение: загрязнение загрязнением загрязнения
загрязнить: загрязненной загрязненных загрязнены
загрязнять: загрязняющем
загута: загут
задавать: задаваемые
задать: задать
задача: задача задачах задачей задачи задачу
задействовать: задействовала задействовало задействован задействовать
задержание: задержания
задержать: задержал задержали задержанные задержанным задержанными задержанных задержаны задержат
задерживать: задерживает задерживали задерживать задерживают
задержка: задержек задержками задержки
задокументировать: задокументировала задокументировало
задуматься: задуматься
задумываться: задумывалась
заимствование: заимствований
заинтересованный: заинтересованные
заказ: заказу
заканчивать: заканчивая
заканчиваться: заканчивается заканчиваются
закария: закария
закарпатский: закарпатской
закладываться: закладывается закладывались
заключаться: заключается
заключение: заключение заключении заключению заключения
заключить: заключенное заключенные заключенный заключенным заключенных заключил заключили заключить
закон: закона законами законом законы
законный: законным
законодатель: законодателям
законодательство: законодательства законодательству
законопроект: законопроекты
закончиться: закончились закончилось закончится закончиться
закрепить: закреплены
закрытие: закрытию
закрытый: закрыты закрытым закрытыми закрытых
закут: закут
зал: залах зале
залить: залитом
заложить: заложенная
заложник: заложникам заложниках заложники заложников
замглавы: замглавы
замедлять: замедляют
заменить: заменила
заместитель: заместитель
заметно: заметно
заметный: заметными
замешать: замешаны
замолчать: замолчал замолчать
заморозить: замороженных
занести: занесенные занесенных
занимать: занимавшая занимает занимают
заниматься: занималась заниматься занимаюсь
занятие: занятий занятия занятиях
занятость: занятости
занять: заняли заняло занять
заняться: заняться
заочно: заочно
запад: запада западе западом западу
западный: западной западном западных
запас: запасов запасы
запах: запах
запечатлеть: запечатлены
записать: записаны
запланировать: запланировали запланирована запланированного запланированной запланированным запланированных
заплатить: заплатят
заплести: заплести
запоздать: запоздать
запомниться: запомнится
запорожский: запорожская запорожской
запорожье: запорожье запорожья
заправить: заправить
заправка: заправки
запрашивать: запрашивает запрашивала
запрет: запрет запрета запрете
запретить: запретить запрещен запрещено запрещены
запрещать: запрещает
запрос: запрос запросах запросов запросы
запросить: запросила запросили запросило запрошенные
запуск: запуск запуске
заработать: заработает
заработный: заработную
заработок: заработке
заражаться: заражается
заражение: заражение заражением заражений заражения
заразить: зараженного зараженной зараженный
заразиться: заразившиеся заразившихся заразиться заразятся
заразный: заразен заразная заразное
зарегистрировать: зарегистрировала зарегистрировали зарегистрированных зарегистрировано зарегистрированы
зарина: зарина зарине
зарождаться: зарождается
зарплата: зарплату
заседание: заседание заседании заседаний заседания заседаниях
заселить: заселено
заслать: зашли
заслуживать: заслуживают заслуживающего
заставить: заставить
заставлять: заставляет заставлять заставляют
застраховать: застрахован
застрять: застряла застряли
засуха: засухи
засыпать: засыпает
затаскивать: затаскивают
затем: затем
затопить: затопили
затопление: затопление затопления
затрагивать: затрагивает затрагивающих
затрата: затраты
затребовать: затребованные затребованных
затронуть: затронет затронувших затронул затронули затронуло затронуты затронутые затронутых
затруднить: затруднен затруднена затрудненное затрудненных затруднены
затруднять: затрудняет затрудняют
затяжной: затяжную
затянуться: затянувшаяся затянувшегося
зафиксировать: зафиксировала зафиксировали зафиксировало зафиксирована зафиксированное зафиксированные зафиксировано зафиксированы
захват: захватом захвату
захватить: захватив захваченных захвачено захвачены
захоронение: захоронений
зачастую: зачастую
зачислить: зачислены
зачитывать: зачитывая
защита: защита защите защитой защиту защиты
защитить: защитить защищенным защищенными защищено защищены
защититься: защититься
защитник: защитников
защищать: защищать защищают
защищённость: защищенности
заэс: заэс
заявить: заявил заявила заявили заявило заявить
заявка: заявку заявок
заявление: заявление заявлением заявлении заявлений заявлению заявления заявлениями
заявлять: заявляет заявляю заявляют
звезда: звезду
звено: звено
зверски: зверски
зверство: зверства зверствам зверствами
звук: звуке звуки
звучать: звучат
здание: здание зданием здании зданий здания зданиям зданиями зданиях
здоровый: здоровое здоровым здоровыми
здоровье: здоровье здоровьем здоровью здоровья
здравоохранение: здравоохранение здравоохранением здравоохранению здравоохранения
зелёный: зеленого зеленой
землетрясение: землетрясение землетрясением землетрясении землетрясений землетрясения землетрясениях
земля: земель земле землей земли земля
зерно: зерна
зима: зима зиму зимы
зимний: зимнего зимнее зимней зимние зимний зимним зимних зимнюю
зимой: зимой
злоупотребление: злоупотреблений
знак: знаком
знаковый: знаковой
знать: знаешь знал знала знали знать знаю знают зная
значение: значение
значимый: значимой значимых
значит: значит
значительно: значительно
значительный: значительная значительное значительной значительную значительные значительный значительным значительных
золочев: золочеве
зона: зон зонах зоне зоной зону зоны
зрение: зрение зрения
зять: зятем зять
ибр: ибр
игил: игил
игла: иглы
игнорировать: игнорируют
игра: играх
играть: играет играть играют играющих
игрок: игроки игроков
игрушка: игрушки
идеальный: идеальные
идея: идею идея
идти: идет идти идут идущими идущих шел шла шли
иерусалим: иерусалим иерусалима иерусалиме
из: изо
изабель: изабель
изба: избы
избавить: избавить
избегать: избегать
избежание: избежание избежания
избежать: избежать
избивать: избивает избивали
избирательность: избирательности
избить: избил
известие: известие известием
известно: известно
известность: известность
известный: известен известна известная известное известной известные известным
извлечение: извлечения
изгнание: изгнании
изголодаться: изголодавшимся
издать: изданного изданный изданы
издевательство: издевательства
изложить: изложил
изменение: изменение изменением изменении изменений изменению изменения
измениться: изменилась изменились изменилось изменится изменятся
измерение: измерениях
измеряться: измеряется
изнасилование: изнасилования изнасилованиях
изначально: изначально
изначальный: изначальная
изобилие: изобилия
изобличить: изобличен
изображение: изображений
изолировать: изолировали изолированы изолировать
изолятор: изолятора изоляторе
изоляция: изоляцией изоляции изоляция
израиль: израиле израилем израиль израилю израиля
израильский: израильские израильский израильским израильскими израильских израильского израильское израильской израильском
израильтянин: израильтян израильтянам израильтянами израильтяне
изумление: изумлением
изучить: изучившие
иллюзорный: иллюзорной
иллюстрировать: иллюстрируют
илья: илью илья
именно: именно
именовать: именуемый
иметь: имеем имеет имела имели иметь имеют имеющее имеющие имеющим имеющих имея
иметься: имеется имеются имеющейся имеющимся
иммиграционный: иммиграционным
иммунизация: иммунизации
иммунитет: иммунитета
иммунный: иммунной иммунную
импорт: импорт
импровизированный: импровизированные импровизированных
имущество: имущества имущество
имя: имена имени имя
инаам: инаам
инакомыслие: инакомыслия
иначе: иначе
инвазивный: инвазивные инвазивных
инвалид: инвалидов
инвалидность: инвалидностью
инвентаризация: инвентаризация
инвестирование: инвестирование
инвестировать: инвестировать инвестируя
инвестиция: инвестиции инвестиций
ингера: ингер
ингушетия: ингушетии ингушетию ингушетия
индивидуальность: индивидуальность
индивидуальный: индивидуальном индивидуальных
индонезийский: индонезийские индонезийской индонезийскую
индонезия: индонезии
индустрия: индустрия
инерция: инерции
инициатива: инициатив инициатива инициативах инициативе инициативы
инклюзивность: инклюзивности инклюзивность
инклюзивный: инклюзивного инклюзивной инклюзивному инклюзивный инклюзивным инклюзивными инклюзивных
инкубатор: инкубатор инкубаторах инкубаторов инкубаторы
инновация: инновациями
иной: иное иной иные иных
иностранец: иностранцев
иностранный: иностранных
инстанция: инстанции
институт: института институтам институтов институтом институты
инструмент: инструмент инструментов
интеграция: интеграции интеграцию
интеллект: интеллект интеллекта
интенсивность: интенсивности интенсивность
интенсивный: интенсивное интенсивной интенсивные интенсивным интенсивных
интенсификация: интенсификацией интенсификацию
интерактивный: интерактивная
интервью: интервью
интерес: интересы
интересно: интересно
интересный: интересную
интернатный: интернатных
интернет: интернет интернета интернете
интернирование: интернирования
интерпретация: интерпретацию интерпретация
инфекционный: инфекционных
инфекция: инфекции инфекций инфекция инфекциями
инфицировать: инфицированного инфицированной инфицированный
инфляция: инфляции инфляция
информация: информацией информации информацию информация
инфраструктура: инфраструктура инфраструктуре инфраструктуру инфраструктуры
инцидент: инцидент инцидента инцидентах инцидентов инциденты
инъекция: инъекции инъекций
иордан: иордан
иордания: иордании иорданию
ирак: ираке
иск: иск иске иску
искажённый: искаженная искаженную
искалечить: искалеченные искалечила
искать: искал искали искать ищут
исключать: исключают
исключение: исключением исключений
исключительно: исключительно
исключительность: исключительности
исключить: исключена
ископаемое: ископаемого ископаемое ископаемых
искоренение: искоренению
искупать: искупать
искусственный: искусственного искусственный
ислам: ислам исламом
исламский: исламским
исполнение: исполнении исполнению исполнения
исполнительный: исполнительного исполнительный
исполниться: исполнилось исполнился исполнится
исполнять: исполняющий
исполняться: исполняется
использование: использование использованием использовании использования
использовать: использовали использована использованы использовать используемой используемый использует используют
использоваться: использовались использоваться используется используются
исправительный: исправительную
испытать: испытал
испытывать: испытывает испытывать испытывают испытывающие
исследование: исследование исследований исследованию исследования исследованиях
исследовательский: исследовательскими
истина: истины
истинный: истинная
исторически: исторически
исторический: историческая исторические исторический историческое
история: историей истории историю история
источник: источник источника источники источников источником
истощаться: истощаются
истощение: истощение истощением истощения
истощить: истощены
истощённый: истощенные
исход: исход исхода исходе исходу
исходить: исходить исходящим
исходящий: исходящую
исцеление: исцеление исцеления
исчезать: исчезают исчезающие
исчезновение: исчезновение исчезновением исчезновений исчезновению исчезновения исчезновениям
исчезнуть: исчез исчезнет
исчерпать: исчерпали
итак: итак
итог: итогам итоге итоги
итоговый: итоговом итоговый
ицхак: ицхаком
ищущий: ищущие ищущих
июль: июле июля
июнь: июне июня
йемен: йемен йемена йемене
йенс: йенс
йоава: йоава
йоанна: йоанна
к: ко
кавказ: кавказ кавказа кавказе
кадр: кадры
каждый: каждая каждого каждое каждой каждому каждую каждые каждый каждым
казаться: кажется
казахстан: казахстан казахстана казахстане
казахстанец: казахстанцы
казахстанский: казахстанского казахстанское казахстанской казахстанском
казнь: казнях
каир: каира каире
каков: какова каково каковы
какой: каким какими каких каком
кактус: кактусы
календарь: календарем календарь календаря
калечить: калечат калечить
камаль: камаль
камень: камнем
камера: камер камерах камеры
кампания: кампании кампания
канада: канаду
канализационный: канализационной канализационные канализационных
канализация: канализацией канализации
кандидат: кандидат
канистра: канистр канистры
канун: канун
кануть: канем
канёкий: канеко
капитальный: капитального
капля: капля
карабах: карабаха
карательный: карательные
кардиолог: кардиолог
кардиологический: кардиологический
карлсный: карлсен
карнали: карнали
карта: карту карты
картина: картину
карьера: карьере
карьерный: карьерные
касаться: касается касался касаются касающиеся
каска: каски
кассетный: кассетных
катар: катара катару
катастрофа: катастроф катастрофа катастрофе катастрофой катастрофу катастрофы
катастрофически: катастрофически
катастрофический: катастрофическая катастрофические катастрофический катастрофическим катастрофическими катастрофических катастрофического катастрофическое катастрофической катастрофическом катастрофическую
катастрофичный: катастрофичны
кататься: катались кататься
категорически: категорически
категоричный: категоричное
категория: категории
катманду: катманду
катрин: катрин
кафе: кафе
каховский: каховской
кацаров: кацарова
качественный: качественный
качество: качества качестве
кашавел: кашавелов
кашель: кашлем кашля
кашлять: кашляет
квадратный: квадратный квадратных
квалификация: квалификации квалификацию
квалифицировать: квалифицирован квалифицированы
квалифицироваться: квалифицироваться
квартал: квартала кварталы
квартира: квартиры
кейся: кейси
керь: керем
кесарев: кесарево
кибератака: кибератака
кибероружие: кибероружие
кива: киву
киев: киев киева киеве киеву
киевский: киевская киевской
киевстарый: киевстар
киий: киой
километр: километр километра километрах километров
кинзлить: кинзли
кипение: кипения
кипр: кипре
кислица: кислица
кислородный: кислородная
кит: киты
китай: китай
кладбище: кладбищем
классификация: классификации классификация
классифицировать: классифицировал
классифицироваться: классифицироваться
клевета: клеветой
клеман: клеман
климат: климат климата климатом климату
климатический: климатическая климатический климатическим климатических климатического климатической
клиника: клиника клиники клинику
клише: клише
клочок: клочке
ключевой: ключевую ключевые ключевым ключевых
кндр: кндр
книга: книге книги
кноблоха: кноблох
коалиция: коалиции
кодекс: кодекс кодекса
коечный: коечный
кожа: коже
кожный: кожной кожных
койка: коек
количество: количеств количества количестве количество количеством количеству
коллапс: коллапс коллапса коллапсу
коллега: коллег коллегам коллегами коллеги коллегу
коллективный: коллективного коллективное коллективной коллективные
колодец: колодец
колония: колонии колоний колонию
колонна: колонн колонна колонне колонну
колпица: колпица
колумбия: колумбии
команда: команда команды
командировка: командировки
командный: командный
комбинированный: комбинированная
комиссар: комиссар комиссара
комиссия: комиссией комиссии комиссия
комитет: комитет комитета комитетом
комментарий: комментарии
комментировать: комментируя
коммерческий: коммерческие коммерческий коммерческим коммерческих коммерческой
коммуникация: коммуникаций коммуникациям
компания: компании компаний
компетентный: компетентный
компетенция: компетенции
комплекс: комплекс комплекса комплексе
комплексный: комплексная комплексной комплексную комплексным
комплект: комплектов комплекты
компонент: компонентов
компресс: компресс
компромисс: компромиссом компромиссу
компьютер: компьютеры
комфорт: комфорт
конвенция: конвенцией конвенции конвенция конвенциям
конвертировать: конвертировать
конвой: конвоев
конго: конго
конгресс: конгресса
конец: конец конца конце концу
конечность: конечностей конечностями конечностях
конечный: конечном
конкретный: конкретные конкретных
конкурс: конкурс
консенсус: консенсус консенсуса
консервы: консервы
констатировать: констатировала
консультация: консультации консультаций консультациях
консультироваться: консультироваться
контакт: контакта контакты
контекст: контекст контекстах контексте контексту
континент: континенты
контролировать: контролировать контролируемого контролируемую контролируемых контролируют
контроль: контролем контроль контроля
конференция: конференции конференций конференцию конференция
конфиденциальность: конфиденциальность
конфискация: конфискация
конфликт: конфликт конфликта конфликтам конфликтами конфликтах конфликте конфликтов конфликтом конфликту конфликты
концентрироваться: концентрируемся
конъюнктивит: конъюнктивит
координатор: координатор координатора координатором координатору
координация: координацией координации
координировать: координировать координирует
координироваться: координируется
кордофан: кордофан
кордофаня: кордофане
корениться: коренящиеся
коренной: коренные коренных
корея: корея
коридор: коридор коридора коридорах коридоров коридору коридоры
корм: корм кормов
кормить: кормить кормящих
корнев: корневых
корнилов: корнилова
королевство: королевства
коронавирус: коронавируса
короткий: короткие короткой
коррекция: коррекции
коррупция: коррупции
корь: кори корь корью
косичка: косички
косметика: косметикой
коснуться: коснется
косово: косово
кость: кости
котелок: котелки
который: которая которого которое которой котором которому которую которые который которым которыми которых
кофе: кофе
кочевой: кочевой
кошмар: кошмар кошмаре кошмару
кпк: кпк
кпп: кпп
кража: краже
край: края
крайне: крайне
крайний: крайней крайнем
краснуха: краснуха краснухе краснухи краснухой краснуху
красный: красная красного красном красным
красота: красоты
кремль: кремлю
крепёжный: крепежные
крест: креста
кривой: кривом
кризис: кризис кризиса кризисами кризисе кризисов кризисом кризису
кризисный: кризисной кризисные
крик: крики
крикса: крикс
криминализация: криминализации криминализацию криминализация
криминализировать: криминализировать
кристиан: кристиан кристиана
критерий: критериев
критик: критик критиком
критически: критически
критический: критическая критический критическом
критично: критично
критичный: критичны
кричать: кричат
кричащий: кричащую
кров: кров крова
кровавый: кровавых
кровопролитие: кровопролитие кровопролития
кровопролитный: кровопролитной кровопролитные кровопролитный
кровоточить: кровоточащими
кровь: крови кровью
кроме: кроме
крошечный: крошечные
круг: круг круга кругами
кругом: кругом
кружка: кружки
крупномасштабный: крупномасштабному крупномасштабные
крупный: крупная крупнейшая крупнейшее крупнейшем крупнейший крупнейшим крупнейших крупный крупных
крылатый: крылатых
крыша: крышах крыши крышу
кто: кем кого кому
кубический: кубических
культ: культа
культура: культура культурой культуры
культурный: культурной
куньмина: куньмине
купить: купить
курс: курса курсе курсы
кусок: куске кусков
кухня: кухне
кухонный: кухонную
куча: кучи
кыргызстан: кыргызстана кыргызстане
кэтрин: кэтрин
лагер: лагере
лагерь: лагерей лагерь лагерю лагеря лагерям лагерях
лаерке: лаерке
лазейка: лазейками
лаззаринить: лаззарини
лампа: лампы
лампедуза: лампедуза
ласковый: ласковые
латвия: латвии
лачинский: лачинский
лаэрка: лаэрке
лгбт: лгбт
лежать: лежат лежит
лекарственный: лекарственный
лекарство: лекарств лекарства лекарствах
лень: лени
лес: леса лесах лесов
лесной: лесной
летальный: летальному
лететь: летели летят
лечебный: лечебным
лечение: лечение лечении лечения
либо: либо
ливан: ливана ливаном ливану
ливана: ливан ливане
ливиец: ливийцы
ливия: ливии ливию ливия
лига: лиги лигу
лидер: лидера лидерам лидерами лидеров лидером лидеру лидеры
лиз: лиз
лиза: лиза
ликбез: ликбез
ликвидация: ликвидации ликвидацию
ликвидировать: ликвидировать
ликующий: ликующую
линдмайер: линдмайер линдмайера
линия: линии линию
лисичанск: лисичанске
лист: листы
литва: литве
литр: литра литров
лицо: лиц лица лицам лицами лицом
лично: лично
личность: личность
личный: личная личной личном личные
лишать: лишает
лишаться: лишаются
лишение: лишение лишения
лишить: лишено лишены
лишиться: лишились
лишний: лишним
лишь: лишь
лишённый: лишенных
лов: лов
ловушка: ловушке
логистика: логистики
логистический: логистическую
ложный: ложное ложный
локальный: локальную
лондон: лондона
лоулор: лоулор
лошадь: лошади лошадях
лояльность: лояльность
луг: луга
луганский: луганская луганской
луч: луч
лыжа: лыжах
львов: львова львове
львовский: львовской
любить: любит любят
любовь: любовь
любой: любая любого любое любой любом любому любые любым любых
лёгкий: легкая легкие легкий легких легкого
лёд: льдами
лёжа: лежа
магазин: магазинах магазинов магазины
магатэ: магатэ
магистраль: магистрали
магистратура: магистратуре
магнитуда: магнитудой
мади: мади
мажилис: мажилиса
май: мае мая
макголдрик: макголдрик
македония: македонии
маккейн: маккейн
макрон: макроном
максимально: максимально
максимальный: максимальной максимальную максимальный
маленький: маленький маленьким маленьких малы меньше
мало: мало
маловероятный: маловероятно
малый: малое малую малых меньшее меньшей меньшем меньшие
малыш: малыш малыша
мальта: мальтой
мальчик: мальчик мальчиков мальчиком мальчику
малярия: малярией малярия
мама: мам мама маме маму
мамбет: мамбетов
мамбетов: мамбетова
мангровый: мангровые
мандат: мандат мандата мандатом
манна: манн
мансур: мансур
марваный: марван
маргарет: маргарет
мариана: мариана
марина: марине марины
мариуполь: мариуполе мариуполя
марк: марк
март: марта
мартин: мартин мартином
маршалл: маршалла
маршрут: маршрутов
марьям: марьям
масалит: масалитов
масалить: масалит
масло: масло
масса: масса
массировать: массированного массированные массированный
массово: массово
массовый: массового массовое массовой массовому массовую массовые массовый массовым массовыми массовых
масштаб: масштаб масштаба масштабам масштабах масштабе масштабов масштабы
масштабный: масштабная масштабного масштабной масштабному масштабны масштабным масштабными масштабных
материал: материалам материалами материале материалов материалы
материнство: материнстве материнство
матрас: матрасами матрасах матрасы
мать: матерей матери матерью мать
маунтинбайка: маунтинбайке
махачкала: махачкала
машина: машин машинам машину машины
маю: маю
мг: мг
мгновение: мгновение
меджидов: меджидова
медиаресурс: медиаресурсы
медик: медик медикам медики медиков
медикамент: медикаментам медикаментами медикаментов медикаменты
медицина: медицина
медицинский: медицинская медицинские медицинский медицинским медицинскими медицинских медицинского медицинское медицинской медицинском медицинскому медицинскую
медленный: медленной медленные
медлить: медлить
медпункт: медпунктов
медработник: медработники медработников
медработница: медработница
медсестра: медсестры
медуслуга: медуслугах
медучреждение: медучреждений
межведомственный: межведомственная межведомственный
междоусобный: междоусобный
международный: международная международного международное международной международном международному международную международные международный международным международными международных
межнациональный: межнациональными
межучрежденческий: межучрежденческий
меморандум: меморандум
мемориал: мемориал
менее: менее
менструальный: менструальной
меню: меню
меняться: меняется меняются
мера: мер мерам мерах мере меры
мерка: меркам
мероприятие: мероприятие мероприятиях
мертворождение: мертворождения
местный: местного местной местном местному местную местные местный местным местными местных
место: мест места местах месте место местом месту
месторождение: месторождения
месть: мести месть
месяц: месяц месяца месяцам месяце месяцев месяцем месяцы
метод: метод методом
метр: метров
метрический: метрических
метро: метро
механизм: механизм механизмам механизмов механизмы
мечеть: мечетей мечети
мечта: мечты
мечтать: мечтают
мешать: мешает мешают
мешок: мешки
мигрант: мигранты
миграция: миграции
мигрировать: мигрируют мигрирующие мигрирующими мигрирующих
мид: мид
микельсен: микельсена
милитаризовать: милитаризованы
милиция: милиции
миллиард: миллиард миллиарда миллиардов миллиарды
миллион: миллион миллиона миллионам миллионов миллионом миллиону миллионы
миля: милях
мина: мин минами
минар: минаром
минздрав: минздрав
минимально: минимально
минимум: минимум
министерство: министерства министерстве министерство министерством
министр: министра министром
минный: минная
минувший: минувшего минувшее минувшей минувшие минувшим минувших минувшую
минус: минус
минута: минут минута минуте минутой минуты
мир: мир мира мире миром миру
мирзалиев: мирзалиевой
мирный: мирного мирное мирном мирному мирные мирный мирным мирных
мировой: мирового мировое мировой мировую мировые мировыми мировых
миростроительство: миростроительства
миссия: миссии миссий миссию миссия
митинг: митинг митингах
митрошин: митрошиной
митрошкин: митрошкина митрошкиной
миф: миф мифам мифы
михал: михал
мишель: мишель
мишень: мишень мишенью
младенец: младенец младенцами младенцев младенцем младенцы
младенческий: младенческая
младший: младше младшего младшие
млн: млн
млрд: млрд
млынары: млынар
мнение: мнение мнений мнению мнения
многие: многие
многий: многим многими многих
многодетный: многодетной
многодневный: многодневных
многое: многое
многоквартирный: многоквартирных
многолетний: многолетнем
многосторонний: многостороннее многосторонние
многосторонность: многосторонностью
многотонный: многотонные
многочисленный: многочисленные многочисленным многочисленными многочисленных
множественный: множественным
множество: множество множеством множеству
мобилизация: мобилизации
мобилизовать: мобилизовала мобилизовали мобилизует мобилизуют
мобильный: мобильного мобильной мобильные мобильных
модель: модели
модуль: модуля
мозг: мозга
мой: мое моего моей моему мои моими моих
молдова: молдове
молить: молить
молодой: молодого молодые молодым молодых
молодёжный: молодежные молодежных
молодёжь: молодежи молодежь
молоток: молотки
молчание: молчанию молчания
молчать: молчали молчат молчать
мом: мом
момент: момент момента моментом моменты
монета: монете
мониторинг: мониторинга мониторинге
мониторинговый: мониторинговая мониторинговой
монреаль: монреале
морально: морально
моральный: моральную моральные моральным
морг: морги
море: море морю моря
морозный: морозной морозную
моррис: моррис
морской: морские морских морского морской
москва: москве москву москвы
мотивированный: мотивированного мотивированные
мофокенг: мофокенг
мохаммад: мохаммад мохаммадом
мочь: мог могла могли могу могут можем можете
мошенничество: мошенничества
мощность: мощности
мощный: мощное мощные мощных
мпк: мпк
мрачный: мрачнее мрачного мрачные мрачный
муж: муж мужьями
мужественность: мужественности
мужественный: мужественным
мужество: мужества мужество
мужской: мужское
мужчина: мужчин мужчина мужчинам мужчиной мужчины
мука: мука муки мукой муку
муниципальный: муниципальными
мус: мус
мусор: мусора
муссара: муссар
мучение: мучениям
мчеловек: мчеловек
мы: нам нами
мыло: мыла
мысль: мысли
мьянма: мьянме
мэр: мэр
мэри: мэри
мэтт: мэтт
мэтью: мэтью
мюнхен: мюнхена мюнхене
мюнхенский: мюнхенская мюнхенских мюнхенской
мячик: мячики
мёртвый: мертвым мертвых
набирать: набирает
наблюдатель: наблюдатель наблюдателям
наблюдать: наблюдаем наблюдаю наблюдают наблюдающему наблюдающим
наблюдаться: наблюдавшиеся наблюдавшимся наблюдается наблюдался наблюдаются
набор: наборов наборы
навальный: навального навальному навальный навальным
наверное: наверное
наверняка: наверняка
навес: навесами
наводнение: наводнений наводнения
навсегда: навсегда
навык: навыков
навязывание: навязывания
навязывать: навязывают
нагноиться: нагноилась
нагорный: нагорного
наградить: наградила
нагрузить: нагруженных
нагрузка: нагрузкой нагрузку
надвигаться: надвигающейся надвигающемуся
надежда: надежда надежде надеждой надежду надежды
надеяться: надеемся надеюсь надеются надеялась надеялись надеяться
надзор: надзора
надир: надира
надира: надирой
надлежащий: надлежащая надлежащего надлежащие надлежащими надлежащих надлежащую
надолго: надолго
надёжный: надежный надежных
наживаться: наживается
назад: назад
название: название
назвать: назвав назвал назвали назвать
наземный: наземная наземного наземное наземной наземную наземные наземных
назначать: назначает
назначаться: назначаются
назначение: назначения
назначить: назначенный назначил
называть: называемого называемое называемые называемых называет называли называло называть
называться: называется
наиболее: наиболее
наименее: наименее
найроби: найроби
найти: найти нашла
наказание: наказание наказаний наказания наказаниям
наказать: наказать
наказывать: наказывать наказывают
накануне: накануне
накапливать: накапливать
накопиться: накопилось
накормить: накормить
наладить: наладить
наличие: наличии наличия
налог: налогах
наложить: наложенных наложили
налёт: налетах
намерение: намерением намерения
намеренный: намеренная намеренному
намерить: намерена намерены
намного: намного
нанесение: нанесения
нанести: нанес нанесен нанесенного нанесенной нанесенные нанесенных нанесено нанесены нанесла нанесли нанести
наносить: наносит наносить наносят наносящие
наноситься: наносятся
нападать: нападавших нападали
нападение: нападение нападением нападении нападений нападению нападения нападениям нападениями нападениях
напасть: напали
написать: написал написала написали написать
наплыв: наплыву
наполнить: наполнено
напоминание: напоминание напоминания
напоминать: напоминает напоминают
напомнить: напомнив напомнил напомнила напомнили напомним напомнить
направить: направил направила направило направить направлен направлена направленное направленные направленных направлено направлены
направиться: направились
направление: направлении направлений направления
направлять: направляемых направлять
направляться: направляется
например: например
напротив: напротив
напряжённость: напряженности напряженность
напрямую: напрямую
напрячь: напряженная напряженную
напугать: напуганы
наравне: наравне
наращивание: наращивании
наращивать: наращивать наращивают
наргиз: наргизы
народ: народ народа народам народов народом народу народы
народный: народные
народонаселение: народонаселения
нарушать: нарушает нарушают нарушающих
нарушение: нарушение нарушением нарушении нарушений нарушения нарушениям нарушениями нарушениях
нарушить: нарушат нарушена нарушены
наряду: наряду
население: население населению населения
населить: населенные населенным населенных
насер: насер
насера: насера
насилие: насилие насилием насилии насилию насилия
насильник: насильник насильника
насильно: насильно
насильный: насильного
насильственный: насильственного насильственное насильственному насильственным насильственных
насколько: насколько
наслаждаться: наслаждается
наслаждение: наслаждение
наслать: нашли
насмешка: насмешкой
насморк: насморка насморком
нассара: нассар
настаивать: настаивает настаивало
настолько: настолько
настоятельно: настоятельно
настоятельный: настоятельную настоятельные настоятельным
настоящий: настоящее настоящему настоящие
наступать: наступает
наступить: наступил наступили наступить
наступление: наступление наступлением наступлению наступления
насущный: насущной
насчитать: насчитала
насчитываться: насчитывается
наталия: наталия
наталья: натальей
наука: наук наука науки
научить: научил научила научили
научиться: научились
научно: научно
научный: научное научными
находить: находили находят нахожу
находиться: находилась находились находилось находился находимся находится находиться находясь находятся находящаяся находящегося находящиеся находящийся находящихся
нацелить: нацеленных
нацизм: нацизма
национальный: национальная национальной национальном национальную национальные национальный национальным национальными национальных
нацистский: нацистской
нация: наций
начало: начала начале начало началом
начать: начал начали начать начнет
начаться: начавшаяся начавшегося начавшиеся начавшихся началась начались началось начался начаться начнется
начинание: начинания
начинать: начинает начинал начинать начинают начиная
начистоту: начистоту
наш: наш наша нашего нашей нашем наши нашим нашими наших нашу
неадекватный: неадекватны
небезопасно: небезопасно
небезопасный: небезопасные небезопасных
небензить: небензя
небо: неба небом
небольшой: небольших небольшого небольшое небольшом
невакцинировать: невакцинированные
невероятно: невероятно
невзгода: невзгодами
невинный: невинные невинных
невозможно: невозможно
невозможный: невозможна невозможное невозможной невозможны невозможным невозможных
неволя: неволе
невообразимый: невообразимо невообразимой невообразимы невообразимый невообразимым
неврологический: неврологических
невыносимый: невыносима невыносимо невыносимы
невыразимый: невыразимое
негативно: негативно
негативный: негативное негативным негативными
негде: негде
негуманный: негуманные
недавний: недавнее недавними недавних
недавно: недавно
недалеко: недалеко
недельный: недельной
неделя: неделе неделей недели недель неделю
недобровольный: недобровольным
недовольство: недовольства недовольство
недоедание: недоедание недоеданием недоеданию недоедания
недоедать: недоедает недоедают недоедающего недоедающих
недоношенный: недоношенного недоношенные недоношенных
недопустимо: недопустимо
недопустимость: недопустимость
недостаток: недостатка недостатки недостатком недостаток
недостаточно: недостаточно
недостаточность: недостаточности
недостаточный: недостаточен недостаточна недостаточное недостаточной недостаточными
недостроенный: недостроенные
недоступный: недоступными
недосягаемый: недосягаемыми
недоумение: недоумение
нежелание: нежеланием
нежеланный: нежеланный
нежность: нежность
нежный: нежным
независимо: независимо
независимость: независимости
независимый: независимая независимого независимое независимом независимую независимый независимым независимыми независимых
незадолго: незадолго
незаконный: незаконную незаконный незаконным
незамедлительно: незамедлительно
незамедлительный: незамедлительное
незарегистрированный: незарегистрированными
незначительный: незначительное
незрелый: незрелые
неизбежный: неизбежен
неизбирательный: неизбирательного неизбирательные неизбирательными неизбирательных
неизвестно: неизвестно
неизвестный: неизвестного
неизменный: неизменной неизменным
нейтрализация: нейтрализации
нейтралитет: нейтралитет
нейтральность: нейтральности
некий: некое
некогда: некогда
некоторый: некотором некоторые некоторым некоторыми некоторых
некторое: некторых
некуда: некуда
нелегальный: нелегальных
нелегко: нелегко
немало: немало
немедленно: немедленно
немедленный: немедленная немедленного немедленное немедленной немедленном немедленному немедленный немедленным
немногие: немногие
немногий: немногими
немного: немного
немногое: немногим
немой: нем
ненависть: ненависти ненависть
необоснованный: необоснованным
необратимый: необратимые
необходимо: необходимо
необходимость: необходимости необходимость
необходимый: необходим необходима необходимая необходимого необходимое необходимой необходимом необходимому необходимую необходимы необходимые необходимым необходимыми необходимых
неоднозначный: неоднозначная
неоднократно: неоднократно
неоднократный: неоднократные неоднократным неоднократных
неожиданный: неожиданной
неописуемый: неописуемых
неослабевающий: неослабевающим
неотложный: неотложной неотложные неотложных
неотъемлемый: неотъемлемой неотъемлемых
непал: непал непала непале
неплохой: неплохие
непогода: непогоды
неподобающий: неподобающе
неподтверждённый: неподтвержденное
неполный: неполном
непослушный: непослушным
непосредственно: непосредственно
непосредственный: непосредственная непосредственной непосредственную
неправильно: неправильно
неправильный: неправильное
неправительственный: неправительственной неправительственные неправительственных
неправый: неправы
непредсказуемость: непредсказуемости
непредсказуемый: непредсказуемым
непрекращающийся: непрекращающаяся непрекращающиеся непрекращающимся непрекращающихся
непрерывность: непрерывность
непрерывный: непрерывного непрерывной непрерывных
непригодный: непригодную непригодным непригодными
неприемлемый: неприемлемо неприемлемы
неприкосновенность: неприкосновенность
непропорционально: непропорционально
непропорциональный: непропорциональные
непрофильный: непрофильными
неработающий: неработающих
неравенство: неравенства неравенство
неравнодушие: неравнодушии
неразорвавшийся: неразорвавшимися неразорвавшихся
нерассказанный: нерассказанное
нерациональный: нерациональное
нерегулярный: нерегулярное
нерешительность: нерешительности
несколько: нескольких несколько
несмотря: несмотря
несовершеннолетний: несовершеннолетних
несогласие: несогласие
несоразмерный: несоразмерный
неспособность: неспособностью
несправедливость: несправедливость
нестабильность: нестабильностью
нестабильный: нестабильная нестабильное нестабильную нестабильный
нести: несет
нетерпение: нетерпением
неумение: неумения
неурожайный: неурожайного
неустроенность: неустроенность
неформальный: неформальное
нефть: нефти
нехватка: нехватка нехватке нехватки нехваткой нехватку
нечасто: нечасто
нечего: нечего нечем
нечеловеческий: нечеловеческие нечеловеческих
неясно: неясно
нигде: нигде
нигерия: нигерии
ниже: ниже
нижний: нижнего нижняя
низкий: низкие низкое
никак: никак
никакой: никаких никакого никакое никакой
николаев: николаев николаеве
николаевский: николаевской
никто: никого никому никто
нил: нил
ниоткуда: ниоткуда
ницаны: ницаны
ничто: ничем ничто
новаторский: новаторских
новорождённый: новорожденного новорожденным новорожденных
новостной: новостные
новость: новостей новости новость
новый: новая нового новой новом новую новые новый новым новыми новых
нога: ноги ногой ногу
нож: ножи
номер: номер
ноокатский: ноокатского
норвегия: норвегии
норма: нормами нормой нормы
нормализация: нормализации
нормальный: нормальное нормальной нормальную нормальный нормальным
нос: нос
носить: носили носит носить носят
ночевать: ночевали ночевать
ночной: ночное ночных
ночь: ночам ночи ночь
ночью: ночью
ношение: ношение
ноябрь: ноябре ноябрь ноября
ноябрьский: ноябрьском
нпо: нпо
нравиться: нравится нравятся
нужда: нужд
нуждаться: нуждаемся нуждается нуждались нуждался нуждаться нуждаются нуждающемуся нуждающиеся нуждающимися нуждающимся нуждающихся
нужно: нужно
нужный: нужен нужна нужны
нукать: нукай
нулевой: нулевая
нуль: нуля
нурмаковый: нурмаков
нурмухамбетов: нурмухамбетова
нуршата: нуршату
нуршать: нуршат
нусера: нусер
нынешний: нынешнего нынешней нынешнем нынешние нынешний нынешних нынешнюю нынешняя
ньялетсосся: ньялетсосси
няня: няня
оаэ: оаэ
оба: оба обе обеими обеих
обвинение: обвинений обвинению обвинения обвинениям обвинениями
обвинить: обвиненных обвинены обвинил обвинили
обвинять: обвиняемого
обдумывание: обдумывание
обед: обеда обедами обеды
обезболивать: обезболивающие
обезвоживание: обезвоживанием обезвоживания
обездоленность: обездоленности
обезлесение: обезлесения
обезопасить: обезопасить
обернуться: обернулось
обеспечение: обеспечение обеспечении обеспечению обеспечения
обеспечивать: обеспечивает обеспечивать обеспечивающих обеспечивая
обеспечиваться: обеспечивается
обеспечить: обеспечена обеспечены обеспечив обеспечил обеспечим обеспечить обеспечьте
обеспокоенность: обеспокоенности обеспокоенность обеспокоенностью
обеспокоить: обеспокоен обеспокоена обеспокоено обеспокоены
обещание: обещаний обещания
обитание: обитания
обитательница: обитательницы
обитать: обитают
обиход: обихода
обладать: обладает
областной: областного областными областных
область: областей области область областях
облегчение: облегчение облегчению
облегчить: облегчить
обломок: обломками обломки обломков
обмен: обмен обменом
обмениваться: обмениваться
обнадёживать: обнадеживает
обнародовать: обнародован обнародована обнародованном
обнаружение: обнаружения
обнаружить: обнаружены
обнимать: обнимают
обновить: обновило обновленная обновленном обновленные обновленный обновленным
обновление: обновление обновлении
обновлять: обновляли
обогатить: обогащенную
обогреватель: обогреватели
обойтись: обойдется
оборачиваться: оборачиваются
оборона: обороны
оборонительный: оборонительная оборонительных
оборот: обороты
оборудование: оборудование оборудованием оборудования
обоснованный: обоснованном
обострение: обострение обострением обострения
обостриться: обострилась
обработать: обработать
обработка: обработки
образ: образ образом
образование: образование образованию образования
образовательный: образовательные образовательных
образоваться: образуются
образцовый: образцовую
обратить: обратил обратили обратить
обратиться: обратившись обратилась обратились обратился обратитесь обратиться
обратно: обратно
обращать: обращают
обращаться: обращалась обращались обращаться обращаясь
обращение: обращение обращением обращении обращений обращению обращения
обрезание: обрезание
обрести: обрести обретший
обретение: обретения
обрисовать: обрисовал
обрушиться: обрушились
обряд: обрядов
обслуживание: обслуживание обслуживанию обслуживания
обслуживать: обслуживал обслуживать
обстоятельство: обстоятельств обстоятельства обстоятельствах
обстрел: обстрел обстрела обстрелам обстрелами обстрелах обстрелов обстрелом обстрелу обстрелы
обстреливать: обстреливает обстреливать
обстреливаться: обстреливаться
обстрелять: обстреляна
обсудить: обсудили обсудите обсудить обсудят
обсуждаться: обсуждаться
обсуждение: обсуждения
обучение: обучение
обширный: обширный обширным
общаться: общаемся общаться общаются
общежитие: общежитие
общение: общение общением
общеобразовательный: общеобразовательные
общественность: общественности общественность общественностью
общественный: общественного общественной общественные общественных
общество: обществ общества обществам обществе общество обществом
общий: общего общее общей общем общие общий
община: общин общинами общинах общины
объединить: объединенными объединенных объединит объединить
объединиться: объединиться
объединять: объединяет
объект: объекта объектам объектами объектах объектов объектом объекту объекты
объявить: объявил объявила объявили объявило объявить объявлена объявленные объявлено
объявление: объявление объявления
объяснить: объяснил объяснила объяснить
объяснять: объясняем объясняет
объясняться: объясняется
объём: объем объема объеме объемов объемом объемы
обыкновенный: обыкновенные
обыскивать: обыскивают
обычай: обычаи обычаями
обычно: обычно
обычный: обычное
обязанность: обязанностей обязанности обязанностях
обязательно: обязательно
обязательный: обязательны обязательным
обязательство: обязательств обязательства обязательствами обязательствах обязательство
обязать: обязали обязан обязана обязано обязаны обязать
обязывать: обязывает
овейс: овейс
овощ: овощи
огласка: огласке огласку
огнестрельный: огнестрельного огнестрельными
огонь: огня огонь
ограничение: ограничение ограничений ограничению ограничения ограничениям ограничениями
ограниченный: ограниченного ограниченное ограниченной ограниченном ограниченные ограниченный ограниченным ограниченными ограниченных
ограничивать: ограничивает ограничивают
ограничиваться: ограничивается ограничиваются
ограничить: ограничен ограничена ограничены ограничила
огромный: огромная огромное огромной огромному огромную огромны огромные огромный огромными
одежда: одежде одеждой одежду одежды
одесса: одесса одессе
одесский: одесской
одетый: одеты
одеяло: одеял одеяла
один: одна одни одним одними одно одного одной одном одному одну
одинаково: одинаково
одиннадцать: одиннадцать
одиночество: одиночестве
одиночка: одиночку
одиночный: одиночное
однако: однако
одновременно: одновременно
однозначно: однозначно
одноразовый: одноразового
односторонний: одностороннем
одночасье: одночасье
одобрение: одобрения
одобрить: одобрен одобрил одобрили
ожесточённый: ожесточенные ожесточенных
оживить: оживить
ожидание: ожидании ожиданиями
ожидать: ожидавшая ожидает ожидают
ожидаться: ожидается
ожог: ожогами ожоги
ожоговый: ожоговом
озабоченность: озабоченность озабоченностью
озвучивать: озвучивали
означать: означает означают
оказание: оказание оказании оказанию оказания
оказать: оказал оказала оказали оказана оказать
оказаться: оказавшимся оказавшихся оказалась оказались оказалось оказался оказаться
оказывать: оказываем оказывает оказывали оказывать оказывают оказывая
оказываться: оказывается оказываются
оканчивать: оканчивал
океан: океан океана океанах океане
океания: океании
оккупация: оккупацией оккупации оккупацию оккупация
оккупировать: оккупированной оккупированном оккупированную оккупированные оккупированных оккупируемых
окно: окна окон
око: ока
около: около
оконный: оконные
окончательный: окончательного окончательную окончательный
окончить: окончена
окрестность: окрестности окрестностях
округа: округу
окружающий: окружающая окружающей окружающих окружающую
окружить: окруженном окруженных
октябрь: октябре октябрь октября
октябрьский: октябрьских
ольга: ольга
омар: омара
омрачить: омрачено
он: нему
они: ими ними
онкологический: онкологическим
онлайн: онлайн
оно: оно
онуть: онув
оон: оон
опасаться: опасаемся опасаюсь опасаются опасаясь
опасение: опасения опасениям опасениях
опасно: опасно
опасность: опасности опасность опасностью опасностями
опасный: опасна опасная опаснее опасного опасной опасную опасны опасные опасный опасным опасными опасных
опекун: опекунов
оперативно: оперативно
оперативность: оперативности
оперативный: оперативного оперативное
оператор: операторов
операционный: операционную
операция: операции операций операцию операция операциям операциях
оперировать: оперируют
описать: описал описать
описывать: описывает описывая
оплакивать: оплакивают
оплата: оплату
оплатить: оплатить
оплачивать: оплачиваемый
оплот: оплот оплотом
оповещение: оповещения
оползень: оползней
ополченец: ополченцев ополченцы
ополчение: ополчением ополчений
оппозиционер: оппозиционер оппозиционера оппозиционеров оппозиционеру
оппозиционный: оппозиционного оппозиционные оппозиционный
оппозиция: оппозиции
оправдание: оправдания
оправдать: оправдать
оправдывать: оправдывает
оправиться: оправились оправился оправиться
определение: определения
определить: определены определит определить
определять: определяемые
определяться: определяется
определённый: определенного определенный определенных
опреснительный: опреснительных
опровергнуть: опроверг опровергла опровергнута
опрометчивый: опрометчивое
опрос: опросам опросов опросы
оптимистичный: оптимистичном
опубликовать: опубликовал опубликовали опубликован опубликована опубликованном опубликованный опубликованным опубликовано опубликованы опубликуют
опускаться: опускается
опуститься: опустилась опустились
опустошать: опустошающим
опустошение: опустошения
опухнуть: опухшие
опылять: опыляют
опыт: опыте опытом
орангутан: орангутаны
оранжевый: оранжевую
орган: орган органа органам органами органах органов органом органы
организация: организацией организации организаций организацию организация организациям организациями
организм: организма организмов
организовать: организовали организовало организованные организовано организованы
организовывать: организовывать
ордер: ордер ордера
орех: орехов
оружие: оружие оружия
орёл: орел
осада: осаде осады
осадить: осажденного осажденном осажденный
освободить: освободить освобожденных освобождены
освобождение: освобождение освобождении освобождению освобождения
освоиться: освоившись
оседлый: оседлого оседлый
осетровый: осетровых
осиротеть: осиротевшим
осколок: осколки
ослабить: ослабленный
осложнение: осложнений
осложнять: осложняет
основа: основа основе основой основы
основание: основании
основатель: основателю
основать: основанную основанным
основное: основном
основной: основной основные
основный: основная основное основному основным основными основных
основополагающий: основополагающий
особенно: особенно
особенность: особенности
особый: особое особой особую особыми
осознание: осознанию
осознать: осознает осознали
оспа: оспой
оспорить: оспорить
оставаться: остававшихся оставались оставаться остается остаются остающихся
оставить: оставили оставило оставит
оставлять: оставлять оставляя
остальной: остального остальной остальные остальных
останавливать: останавливают
остановить: остановившей остановило остановите остановить остановлена остановлены
остановиться: остановилась остановились
остановка: остановке остановкой
остаться: оставшаяся оставшегося оставшиеся оставшихся оставшуюся осталась остались осталось остался останется останутся остаться
остерегаться: остерегайтесь
остро: остро
остров: острова
островной: островных
островок: островками
острота: остроту
острый: острая острого острой острую острыми
осудить: осудив осудил осудила осудили осудит
осуждать: осуждаем осуждает осуждала осуждаю осуждают
осуждение: осуждении
осуществить: осуществили осуществить осуществленных
осуществление: осуществление осуществлением осуществлении осуществлению
осуществлять: осуществляем осуществляемых осуществляли осуществляющих
осуществляться: осуществляться осуществляются
отапливать: отапливать
отбывать: отбывавшего отбывать
отвергнуть: отверг отвергли
ответ: ответ ответом
ответить: ответила ответили ответить
ответный: ответное ответных
ответственно: ответственно
ответственность: ответственности ответственность
ответственный: ответственные ответственный
отвечать: отвечает отвечал отвечающий отвечая
отвлекать: отвлекать
отвлекаться: отвлекаться
отвлечься: отвлечься
отвратительный: отвратительных
отдалить: отдаленных
отдать: отдал отдали отданными
отделение: отделение отделении отделению отделения отделениям
отдельный: отдельного отдельные отдельный отдельных
отдохнуть: отдохнуть
отдышаться: отдышаться
отец: отец отца отцам отцов отцом
отзыв: отзыв
отит: отита
отказ: отказ отказа отказами отказе отказов отказом отказу отказы
отказать: отказано
отказаться: отказаться
отказывать: отказывают
отказываться: отказывались
откладывать: откладывать
отклонить: отклонены отклонил
отключение: отключение отключением отключения
отключиться: отключилось
открывать: открывают
открытие: открытие открытии открытию открытия
открыто: открыто
открытый: открытое открытом открытому открытые открытый открытым открытыми
открыть: открыли открыт открыты открыть
открыться: открылась открылось открыться
отличаться: отличаются
отлов: отловом
отменить: отменена отменены отменили отменить
отметить: отметив отметил отметила отметили отметило отметим отметит
отметка: отметке отметку
отмечать: отмечаем отмечает отмечают
отмечаться: отмечается
отнести: отнесли
относительно: относительно
относительный: относительной
относиться: относился относиться относятся отношусь
отношение: отношение отношении отношению отношения отношениям отношениях
отозвать: отозвала
отопление: отоплением отоплении отопления
оторвать: оторванной
оторваться: оторваться
отпор: отпора
отправить: отправила отправить отправлено отправлены отправят
отправка: отправке отправки
отправление: отправления
отправлять: отправляет отправлять
отпуск: отпуск отпуска отпуске
отпустить: отпустил
отравление: отравления
отражать: отражает
отразиться: отразиться
отреагировать: отреагировали отреагировало отреагировать
отрезать: отрезало отрезан отрезана отрезанными отрезаны
отремонтировать: отремонтировать
отрицать: отрицать
отступить: отступить
отсутствие: отсутствие отсутствия
отсутствовать: отсутствует отсутствующий отсутствующих
оттуда: оттуда
отход: отходов
отцовство: отцовства отцовстве отцовство отцовству
отчаиваться: отчаиваются
отчаяние: отчаяние отчаянии отчаяния
отчаянно: отчаянно
отчаянный: отчаянную отчаянных
отчаяться: отчаявшемуся отчаявшиеся отчаявшимся отчаявшихся
отчий: отчего
отчитаться: отчитался
отчёт: отчет отчете отчеты
офис: офис офиса офисами офисов
официально: официально
официальный: официальной официальном официальные официальный официальных
оформить: оформлено
оформление: оформления
охарактеризовать: охарактеризовали охарактеризовало
охватить: охватить охваченного охваченному охваченный охваченных охвачено
охватывать: охватывают охватывающий охватывающих
охель: охель
охлаждение: охлаждением охлаждению
охотиться: охотятся
охрана: охране охраны
охранять: охраняемого охраняемыми
оценивать: оценивает оценивают
оцениваться: оценивается оценивалась
оценить: оценил оценила оценили оценить оценят
оценка: оценка оценкам оценке оценки оценку
оцифровка: оцифровки
очевидец: очевидцев
очевидный: очевиден очевидна очевидно очевидны
очень: очень
очередной: очередная очередной очередную
очередь: очереди очередь очередях
очистить: очистить
очистка: очистки
очный: очное
ошеломить: ошеломлены
ошеломлять: ошеломляют
ошибочный: ошибочен
ощущать: ощущать
ощущаться: ощущается ощущалось ощущаться
ощущение: ощущением
оэа: оэа
падать: падают
падеж: падеж
падение: падение падению
пакистан: пакистан пакистана
пакт: пакта
палата: палата
палатка: палатках палатки
палаточный: палаточных
палестина: палестина палестине палестины
палестинец: палестинца палестинцам палестинцев палестинцы
палестинка: палестинки
палестинский: палестинская палестинские палестинский палестинским палестинскими палестинских палестинского палестинское палестинской палестинскому палестинскую
палестница: палестницам
память: памяти память
пандемия: пандемией пандемии
папа: пап папа
пара: пара пару пары
параллельно: параллельно
парень: парни
париж: париж париже
парижский: парижским парижскую
парламент: парламента
паротит: паротит паротита паротите паротитом
партия: партии партию партия
партнёр: партнерам партнерами партнеров партнером партнеры
партнёрский: партнерские партнерских
партнёрство: партнерств
паспорт: паспорта
патриархальный: патриархальные
пауза: пауза паузе паузой паузу паузы
паула: паула
пациент: пациента пациентам пациентами пациентов пациенты
паёк: пайки
педерсена: педерсена
педофилия: педофилии
пекарный: пекарен
пекарня: пекарни
пенсионер: пенсионеры
первенец: первенца
первичный: первичная
первоначально: первоначально
первоначальный: первоначального первоначальному
первостепенный: первостепенное
первый: первая первого первое первой первом первую первые первый первым первых
перебираться: перебирается
перебой: перебои перебоям перебоях
перебороть: перебороть
перебрасывать: перебрасывают
перебраться: перебрались
перевезти: перевезли перевезти
перевести: перевести
перевод: переводе переводы
перевозить: перевозить
переговорщик: переговорщик
переговоры: переговорам переговоров переговоры
перегруженность: перегруженность
перегрузить: перегруженного перегружены
передавать: передает передают
передаваться: передаваться
передать: передал передали передать
передаться: передаться
передача: передачи
передвигаться: передвигаться
передвижение: передвижение передвижении передвижения
передовой: передовой
передышка: передышка передышку
переезд: переезд
переезжать: переезжать переезжают
переехать: переехали переехать
переживать: переживаем переживает переживала переживают
пережить: пережили пережить
перейти: перейти
перекидываться: перекидывается
перекинуться: перекинется перекинуться
перекрытие: перекрытия
перекрыть: перекрыты перекрыть
перелом: переломами
перелётный: перелетных
перемалывать: перемалывают
переместимый: переместим
переместить: переместили перемещенного перемещенные перемещенный перемещенным перемещенными перемещенных перемещены
перемещать: перемещать
перемещаться: перемещаться перемещаются
перемещение: перемещение перемещением перемещений перемещению перемещения
перемирие: перемирие перемирии перемирию перемирия
перенаселить: перенаселен перенаселенные перенаселенный
перенаселённость: перенаселенности перенаселенность перенаселенностью
перенести: перенес перенесена перенесенного перенесла
переносить: переносят
переосмыслить: переосмыслить
переоценить: переоценить
переполненность: переполненности
переполненный: переполненные переполненный переполненных
переполнить: переполнены
переполняться: переполняются
перерасти: перерасти
перерыв: перерыву
пересекать: пересекают пересекая
переселенец: переселенцам переселенцами переселенцев переселенцы
переселение: переселение переселении переселения
пересечь: пересекли пересекших пересечь
пересмотр: пересмотре
пересмотреть: пересмотрели пересмотреть
переставать: перестает
перестать: перестал перестанут
переход: переход перехода переходов переходу переходы
перечень: перечень
перечисленный: перечисленные
перешагнуть: перешагнул
период: период периода периодами периодов периодом периоды
периодически: периодически
персона: персонам
персонал: персонал персонала персоналу
перспектива: перспектива перспективам перспективе перспективу перспективы
петербург: петербург
петиция: петиция
печальный: печальный
печать: печать
пешеходный: пешеходный
пешка: пешкой
пилотирование: пилотирование
пиперкор: пиперкор
пиперкорн: пиперкорн пиперкорна
пирог: пироги
писать: писали
письмо: письме письмо
питание: питание питанием питанию питания
питательный: питательные
питаться: питаются
питер: питер
питие: питья
питьевой: питьевая питьевой питьевую
пища: пища пищи пищу
плавать: плавать
план: план плана планах плане планов планы
планета: планеты
планетарный: планетарного
планирование: планирование планировании планирования
планировать: планирует планируют
планироваться: планируется
плановый: плановой
пластик: пластик
пластика: пластика
пластиковый: пластиковыми пластиковых
плата: плату
платить: платят
платформа: платформе
плач: плач
плачевный: плачевное плачевном плачевные
плачущий: плачущих
племенной: племенные
племя: племен племени
племянник: племянниками племянников
плен: плена плену
пленный: пленными пленных
плод: плода плоды
плодородный: плодородные
плоскость: плоскости
плотина: плотины
плотно: плотно
плотность: плотность
плохой: плохим плохими плохую худшая худшие худший худших хуже
площадка: площадках
площадь: площади площадь площадью
плыть: плывем
пневмония: пневмонии пневмония
побег: побег
побеседовать: побеседовала
побои: побои
побочный: побочные побочными
побудить: побудить
побывать: побывали
побь: поби
поведение: поведение поведения
повезти: повезло
поверить: поверила поверить
поверхность: поверхности
повестка: повестка повестки повестку
повлечь: повлекло
повлиять: повлияет повлиять
повод: поводу
поворотный: поворотный
повредить: повредили поврежден повреждена поврежденное поврежденные поврежденных повреждено повреждены
повреждение: повреждение повреждении повреждению повреждения повреждениях
повседневный: повседневная
повсеместно: повсеместно
повстанец: повстанцы
повстанческий: повстанческими повстанческих
повстречать: повстречал
повсюду: повсюду
повторение: повторения
повторить: повторив повторил повторила повторили
повториться: повториться
повторно: повторно
повторный: повторного повторную повторных
повторять: повторяю
повторяться: повторяется повторяются
повышать: повышаем повышает
повышение: повышение повышения
повышенный: повышенных
погасить: погасить
погибать: погибает погибают
погибнуть: погиб погибла погибли погибло погибнут погибших
погибший: погибшим
поглотитель: поглотители
поговорить: поговорил поговорила поговорили поговорите
погода: погоду погоды
погодный: погодные погодными погодных
пограничный: пограничного пограничный пограничных
погрести: погребенные погребены
погром: погром
подавление: подавления
подавлять: подавляющее
подарок: подарки
подать: подадут
подача: подачи
подвал: подвалах
подвезти: подвез
подвергать: подвергаем подвергает подвергают подвергая
подвергаться: подвергается подвергаться подвергаются подвергающемся
подвергнуть: подвергнем
подвергнуться: подверглась подверглись подвергнуться подвергся подвергшихся
подверженный: подвержен подверженные подвержены
подверчься: подвергись
подвести: подвел
подводить: подводя подводят
подготовить: подготовили подготовлен подготовленной
подготовка: подготовка
подгузник: подгузники
поддержание: поддержании поддержания
поддержать: поддержал поддержали поддержать
поддерживать: поддерживаем поддерживаемые поддерживаемых поддерживает поддерживал поддерживали поддерживать поддерживают поддерживая
поддержка: поддержка поддержке поддержки поддержку
поделиться: поделились поделился
поджимать: поджимает
подземный: подземных
подключить: подключен подключены
подключиться: подключившись подключиться
подкожно: подкожно
подлинный: подлинным
поднимать: поднимал
подниматься: поднимался
поднять: подняли
подобный: подобная подобное подобную подобные подобными подобных
подписание: подписания
подписать: подписавшие подписали подписанной
подписаться: подписаться
подписываться: подписывайтесь
подпитывать: подпитывает
подразумевать: подразумевает
подразумеваться: подразумеваются
подрастать: подрастающим
подробно: подробно
подробный: подробнее подробной
подростковый: подростковым
подросток: подростков подросток
подруга: подруги
подрыв: подрывом
подрывать: подрывает
подряд: подряд
подсветка: подсветку
подсолнечный: подсолнечное
подстрекательский: подстрекательских
подстрекательство: подстрекательство
подступ: подступах
подсчёт: подсчетам
подтвердить: подтвердил подтвердила подтвердили подтвердило подтвержденные подтверждено подтверждены
подтвердиться: подтвердится
подтверждать: подтверждает подтверждают подтверждая
подтверждение: подтверждением
подумать: подумаем подумайте
подходить: подходит
подчеркнуть: подчеркнув подчеркнул подчеркнула подчеркнули подчеркнуло подчеркнуто подчеркнуть
подчиняться: подчиняются
подчёркивать: подчеркиваем подчеркивает подчеркивают подчеркивая
подчёркиваться: подчеркивается
подытожить: подытожил подытожила
поездка: поездки
поесть: поесть
пожаловать: пожаловать
пожалуйста: пожалуйста
пожар: пожар
пожениться: пожениться
пожертвование: пожертвования
пожертвовать: пожертвовать
пожизненный: пожизненному пожизненные
пожилой: пожилые пожилым пожилых
позаботиться: позаботиться
позволить: позволено позволившее позволил позволила позволили позволило позволит позволить позвольте позволят
позволять: позволяет позволяйте позволяют позволяющей позволяющие
позвоночник: позвоночника
позднесоветский: позднесоветском
поздно: поздно
позитивный: позитивное позитивную
позиция: позиции позицию
познакомиться: познакомилась познакомился
позор: позор
позорный: позорно
поиск: поиск поиска поисках поиске поиском поиску
пойти: пойти пошла
пока: пока
показатель: показатель показателя
показательно: показательно
показать: показав показала показали показано показаны показать
показывать: показывает показывают
покидать: покидали покидать покидают
покинуть: покинувших покинули покинуть
поклясться: поклялись
поколение: поколение поколением поколений поколения
покп: покп
покровский: покровском
покушение: покушения
пол: пола полу
полагаться: полагаться полагаются
полгода: полгода
полдень: полдня полудня
поле: поле
полевой: полевые
полезный: полезной
полемика: полемику
поликлиника: поликлиника поликлиники
полиомиелит: полиомиелит
политзаключённый: политзаключенные политзаключенных
политик: политик политиков
политика: политики политикой
политически: политически
политический: политическая политические политическим политических политического политическое политической политическую
полмиллиона: полмиллиона полумиллиона
полномасштабный: полномасштабного полномасштабное полномасштабной полномасштабную полномасштабным
полностью: полностью
полноценный: полноценную
полный: полного полное полной полном полному полную полный полным
половина: половина половину половины
положение: положение положением положении положений положению положения
положить: положат положен положить
полтавский: полтавской
полтора: полтора
полумера: полумер
полумесяц: полумесяца полумесяцем
полуночь: полуночи
получать: получавшие получаем получает получал получали получать получают получающих
получаться: получается
получение: получении получения
получить: получат полученную полученные полученный полученными полученных получено получив получивший получил получила получили получим получить
получиться: получилось
польза: польза пользу
пользование: пользования
пользоваться: пользоваться пользуются
польша: польше польшу
поляризация: поляризации
полярный: полярного полярным
поменять: поменять
померкнуть: померкнуть
поместить: помещенным
помешать: помешать
помещение: помещение помещений помещения помещениях
помимо: помимо
поминальный: поминальную
помнить: помним помните помнят
помогать: помогаем помогает помогал помогала помогали помогать помогают помогающие помогая
помолиться: помолитесь
помочь: помогла помогли помогут поможем поможет помочь
помощник: помощник
помощь: помощи помощь помощью
понадобиться: понадобится
понедельник: понедельник понедельника
понести: понесли понести
понизить: пониженную
понимание: понимание понимания
понимать: понимавший понимаем понимаете понимать понимаю понимают понимая
пономарёв: пономарев пономаревым
понятие: понятия
понять: поймут понять
пообещать: пообещали
пообщаться: пообщавшись пообщалась
поокп: поокп
попадать: попадает
попасть: попадут попала попали попало попасть
пополнение: пополнение пополнению пополнения
пополнить: пополнить
поправка: поправку
попросить: попросил
попугай: попугаи
популяция: популяции популяций
попустительство: попустительства
попытаться: попытается
попытка: попытка попытки попыткой
пора: пор пора
поражать: поражает поражал
поражение: поражения
порицание: порицание порицания
порнофильм: порнофильмы
порог: порог пороге
породить: породила
порок: пороки
порочный: порочный
порт: порта порту
портативный: портативные
порядок: порядка порядке порядку порядок
посвятить: посвящена посвященная посвященной посвященную посвященных
поселенец: поселенцами поселенцев поселенцы
поселение: поселений поселения
поселиться: поселилась
посетить: посетивший посетил посетила посетили посетит
посетовать: посетовала
посещать: посещают посещая
посещение: посещение посещения
посеять: посеяли
поскольку: поскольку
послание: послание послания
посланник: посланника
послать: пошли
последний: последнего последнее последней последнем последние последний последним последними последних последнюю последняя
последовательно: последовательно
последовать: последовала последовало
последствие: последствий последствия последствиям последствиями последствиях
последующий: последующего последующей последующих
послеоперационный: послеоперационной
послеродовой: послеродовая
послужить: послужит
посмотреть: посмотрим посмотрите
посол: посла посол
посреднический: посреднические
посредничество: посредничестве
посредством: посредством
пост: пост посту
поставить: поставили поставить поставлены
поставка: поставками поставках поставке поставки поставку поставок
поставлять: поставлять поставляют
поставляться: поставляется поставлялись
постановить: постановил
постановление: постановление
постельный: постельное
постепенно: постепенно
постепенный: постепенных
постоянно: постоянно
постоянный: постоянная постоянного постоянном постоянному постоянные постоянный постоянным постоянными постоянных
постпред: постпред
пострадать: пострадавшего пострадавшие пострадавшим пострадавшими пострадавших пострадал пострадала пострадали пострадало пострадать
построить: построили построило
постройка: построек постройкам постройках
поступать: поступает поступала поступало поступать поступают поступающая поступающее поступающей поступающие поступающими
поступить: поступившим поступивших поступили поступило поступят
поступление: поступление поступления
посёлок: поселкам поселков поселку
потенциал: потенциала
потенциально: потенциально
потенциальный: потенциального потенциальной потенциальные
потепление: потепление потепления
потерпевший: потерпевшей
потерпеть: потерпел
потеря: потере потери потерь потерю потеря потерям
потерянный: потерянный
потерять: потерявшие потерявших потерял потеряла потеряли потеряло потеряна потеряно
поток: поток потока потоки
потребитель: потребителей
потребление: потребления
потреблять: потреблять
потребность: потребностей потребности потребность потребностям потребностями
потребовать: потребовал потребовали потребовать потребует
потребоваться: потребовалось потребуется
потрогать: потрогает потрогать потрогают
потрясный: потрясен
потрясти: потрясены потрясли потрясти
поуп: поуп
похитить: похитили похищенных
похищать: похищают
похищение: похищение похищения похищениям похищениях
похоже: похоже
похожий: похож
похоронить: похороненные похороненных похоронены
почва: почве почвы
почему: почему
почтить: почтить
почувствовать: почувствовали
пощадить: пощадили
поэтапно: поэтапно
поэтапный: поэтапного поэтапном поэтапный
поэтому: поэтому
появиться: появились появился появится
появление: появлением появлении появления
появляться: появляется появляются
пояснить: пояснил пояснила
пояснять: поясняет
правда: правда правде
правило: правил правила правило
правильно: правильно
правильный: правильном
правительственный: правительственной правительственном правительственные правительственными правительственных
правительство: правительств правительства правительствам правительствами правительство правительством правительству
править: правили
правление: правлению правления
право: прав права правам правами правах праве право правом праву
правовой: правовой
правозащитник: правозащитник правозащитникам правозащитники правозащитников
правозащитница: правозащитница правозащитницей
правозащитный: правозащитная правозащитной правозащитным правозащитными правозащитных
правонарушение: правонарушениям
правоохранительный: правоохранительная правоохранительные правоохранительным правоохранительных
правопорядок: правопорядка
правосудие: правосудию
праздник: праздники праздников
праздничный: праздничный
практика: практика практике
практиковаться: практикуются
практически: практически
пребывание: пребывания
превратить: превратил превратили превращена превращенная
превратиться: превратилась превратились превратился
превращаться: превращаются
превысить: превысило превышена
превышать: превышает превышающее превышающих
предать: предать
предварительный: предварительные предварительных
предгорие: предгорьям
преддверие: преддверии
предел: предел пределами пределе пределы
предельно: предельно
предлагать: предлагаемых предлагает предлагают
предложение: предложение предложения
предложить: предложенной предложенную предложенный предложенных предложил предложила предложили
предмет: предмет предметам предметами предметах предметов предметом предметы
предназначаться: предназначавшиеся
предназначить: предназначенной предназначенный предназначенных предназначены
преднамеренно: преднамеренно
преднамеренный: преднамеренное преднамеренные
предоставить: предоставив предоставила предоставили предоставить предоставлен предоставлена предоставленное предоставленной предоставленному предоставленные предоставлены
предоставление: предоставление предоставлении предоставлению предоставления
предоставлять: предоставляем предоставляемой предоставляет предоставляли предоставлять предоставляют предоставляя
предоставляться: предоставляются
предостерегать: предостерегает предостерегало
предотвратимый: предотвратимых
предотвратить: предотвратить
предотвращать: предотвращает предотвращать
предотвращение: предотвращении предотвращения
предписать: предписал
предполагать: предполагаемая предполагаемого предполагаемую предполагаемые предполагаемых предполагал предполагают
предположительно: предположительно
предпринять: предприняла предприняты предпринять
предприятие: предприятие предприятий предприятия
председатель: председатель
представитель: представителей представителем представители представитель представителя представителями
представительница: представительница представительницы
представительство: представительства представительстве
представить: представил представила представит представить представленную представлены представят
представление: представление
представлять: представлявший представляет представляют представляя
представляться: представляется
представлёнок: представлят
предстоять: предстоит
предстоящий: предстоящие предстоящий
предупредить: предупредив предупредил предупредила предупредили предупредило
предупреждать: предупреждает предупреждала предупреждали предупреждают
предупреждение: предупреждение предупреждения
предусматривать: предусматривает предусматривающему предусматривающие
предшествовать: предшествовало
предъявить: предъявили предъявленные предъявлены
предыдущий: предыдущей
президент: президент президента президентом
презумпция: презумпция
прекрасно: прекрасно
прекрасный: прекрасным
прекратить: прекратила прекратить прекращен прекращена прекращены
прекратиться: прекратилась прекратилось прекратиться прекратятся
прекращение: прекращение прекращением прекращении прекращению прекращения
пренебрегать: пренебрегает
пренебрежение: пренебрежением пренебрежении пренебрежения
пренебрежительный: пренебрежительное
преобладать: преобладают
преобразить: преобразят
преодолевать: преодолевают
преодоление: преодоление
преодолеть: преодолен преодолеть
препарат: препарат препараты
преподаватель: преподаватель
препятствие: препятствий препятствия препятствиями
препятствование: препятствованием
препятствовать: препятствовать препятствует препятствуют
прервать: прерваны
прерываться: прерывающаяся
преследование: преследование преследованиями
преследовать: преследовать преследуют
пресса: пресса прессой прессы
преступление: преступление преступлений преступления преступлениям преступлениях
преткновение: преткновения
прецедент: прецедентов
прибегать: прибегают
приближаться: приближается
приближение: приближения
прибывать: прибываете прибывали прибывать прибывают прибывающие
прибыль: прибыли
прибыть: прибудет прибывшая прибывшие прибывшую прибыл прибыла прибыло
привезти: привезти
приверженность: приверженность
приверженный: привержены
привести: приведет приведут привел привела привели привело привести
приветствовать: приветствовал приветствовала приветствовали приветствовать приветствует приветствуют
приветствоваться: приветствуются
прививать: прививайте прививать прививая
прививка: прививка прививку прививок
привилегия: привилегий
привить: привиты привитых
привлекать: привлекать привлекая
привлечение: привлечения
привлечь: привлекли привлечены привлечь
приводить: приводит приводить приводя приводят
приводиться: приводится
привыкнуть: привыкли
привычный: привычного
пригласить: приглашена
приглашение: приглашению
приговор: приговор приговора приговором
приговорить: приговорен приговоренные приговорили
пригодность: пригодности
приготовить: приготовить
приготовление: приготовления
приграничный: приграничный приграничных
придерживаться: придерживаться
придумать: придумать
приехать: приехали
призвать: призвав призвал призвала призвали призвало призвана
признавать: признавая признают
признак: признак признаком признаку
признанный: признанными
признательность: признательность
признать: признал признали
признаться: признался
призрак: призрака
призрачный: призрачной
призыв: призыв призыва призывам призывом призывы
призывать: призываем призывает призывал призывала призывали призывало призывать призываю призывают призывающую
прийти: прийти пришло
прийтись: придется пришелся пришлось
приказ: приказ приказа приказами приказов приказом приказу приказы
приказать: приказала
прикладывать: прикладывая
приковать: приковано
прикорм: прикорма
прикоснуться: прикоснутся прикоснуться
прикрытие: прикрытия
прилагать: прилагает
прилегать: прилегающие
приложение: приложение
приложить: приложить
применение: применением применении применения
применить: применил
применять: применяют
применяться: применялись применяться применяются
пример: пример примеры
примерно: примерно
примирение: примирению примирения
принадлежать: принадлежащем
принадлежность: принадлежностей принадлежности
принести: принесет принесли принести
принимать: принимает принимал принимать принимают принимающие принимающих принимая
приносить: приносит приносят
принудительный: принудительное принудительную
принуждение: принуждения
принцип: принцип принципа принципами принципе принципов принципу принципы
принятие: принятие принятию принятия
принять: примет приняв принял приняла приняли принято принятого принятое принятой принятую принятый принятыми принятых принять
приобрести: приобрести
приобретение: приобретения
приоритет: приоритет приоритетах приоритетов приоритетом приоритеты
приоритетный: приоритетное приоритетных
приоритизация: приоритизации
приостанавливать: приостанавливать
приостановить: приостановившим приостановил приостановила приостановили приостановить приостановлен приостановлены приостановят
приостановка: приостановке приостановку
приостановление: приостановлению
припас: припасы
приписывать: приписываемых
припортовый: припортовой
приравниваться: приравниваться
приравнять: приравнено приравнены
природа: природой природу природы
природный: природного природные природных
природоохранный: природоохранного природоохранных
прискорбие: прискорбием
прислать: пришли
прислушаться: прислушаетесь прислушаться
присмотр: присмотра
присоединяться: присоединяемся
приспустить: приспущен приспущены
пристально: пристально
пристанище: пристанищем
приступать: приступать
присутствие: присутствие
присутствовать: присутствует
приурочить: приурочена
прифронтовой: прифронтовом прифронтовые прифронтовых
приходить: приходит приходят
приходиться: приходилось приходится приходятся
причастность: причастности
причастный: причастны
причина: причин причины
причинение: причинение
причинить: причинен
причинять: причиняемые причинять
причём: причем
приют: приют приюта приютах приютов приюты
приём: приема приеме
приёмный: приемного
проанализировать: проанализировали
пробка: пробки
проблема: проблем проблема проблемам проблемами проблемах проблеме проблемой проблему проблемы
проблематика: проблематика проблематикой
проблематичный: проблематичным
проблеск: проблеск проблеском
провал: провала
проведение: проведение проведению проведения
проверить: проверьте
проверка: проверка проверке проверки проверку проверок
проверять: проверять
провести: проведенная проведенного проведенной проведенным проведено проведет проведут проведя провел провела провели провело провести
провинция: провинции провинций провинцию провинция провинциях
проводить: проводимого проводимой проводит проводить проводят провожу
проводиться: проводится проводятся
провоз: провоз
провозить: провозить
провоцировать: провоцирует
прогноз: прогноз прогнозы
прогнозироваться: прогнозировалось
проговаривать: проговаривать
проголосовать: проголосовали
программа: программ программа программе программой программу программы
прогресс: прогресс прогресса
прогрессивный: прогрессивной
продавать: продавать
продвигать: продвигает
продвинуться: продвинулись
проделать: проделана проделанной проделать
продемонстрировать: продемонстрировала продемонстрировать
продление: продление продлении продлению продления
продлить: продлил продлила продлить
продлиться: продлилась продлится
продовольственный: продовольственная продовольственного продовольственной продовольственную продовольственные продовольственный продовольственных
продовольствие: продовольствие продовольствием продовольствии продовольствию продовольствия
продолжать: продолжаем продолжает продолжала продолжали продолжать продолжают
продолжаться: продолжавшееся продолжается продолжались продолжалось продолжаться продолжаются продолжающаяся продолжающегося продолжающееся продолжающейся продолжающемся продолжающиеся продолжающийся продолжающимися продолжающимся продолжающихся продолжающуюся
продолжение: продолжение продолжении продолжения
продолжительный: продолжительные
продолжить: продолжил продолжила продолжить
продолжиться: продолжились продолжится
продукт: продуктами продуктах продуктов продукты
продуктовый: продуктовые
проезд: проезд проезда проезде
проезжать: проезжали
проект: проект проекта проекте проектов проекты
проехать: проехали проехать
проживание: проживания
проживать: проживает проживали проживало проживают проживающих
прозвучать: прозвучали прозвучало
прозрачный: прозрачного прозрачное
проигнорировать: проигнорированы
проигрывать: проигрывает
производитель: производителям
производство: производства производство производству
произвол: произвол
произвольно: произвольно
произвольный: произвольного произвольное произвольным произвольных
произойти: произойти произошедшая произошедшее произошел произошли произошло
проинформировать: проинформировало
происходить: происходили происходит происходить происходят происходящего происходящее происходящем происходящие происходящим
происхождение: происхождение
пройти: пройдет пройти прошел прошла прошли прошло
прокладка: прокладки
прокомментировать: прокомментировал
прокормить: прокормить
прокуратура: прокуратура
прокурор: прокурор
проливный: проливные проливных
проложить: проложит
промедление: промедления
промежуточный: промежуточный
промокать: промокают
промышленность: промышленности
промышленный: промышленной
пронзать: пронзают
проон: проон
прооперировать: прооперированы
пропасть: пропавшими пропавших пропали пропало пропасти
пропорциональность: пропорциональности
пропуск: пропуска
пропускать: пропускать пропускают
пропускной: пропускная пропускной
пропустить: пропустить пропущенных
пророк: пророк
просачиваться: просачивается
просить: просили просит просят прошу
проследовать: проследовали проследовало
проснуться: проснулся
просто: просто
простой: простой
пространство: пространства пространство
просчёт: просчетов
просьба: просьбе просьбой просьбу
протестовать: протестующие протестуя
против: против
противник: противника противников
противоборствующий: противоборствующие
противодействие: противодействие
противозаконный: противозаконная противозаконной
противоминный: противоминной
противостояние: противостояние противостоянии противостояния
противостоять: противостоять
противостоящий: противостоящие
протяжение: протяжении
протяжённость: протяженностью
профилактический: профилактических
профильный: профильных
профинансировать: профинансирован профинансирует
проходить: проходившие проходила проходит проходящей
прохождение: прохождение прохождении
процветание: процветание процветанию
процедура: процедур процедуры
процент: процент процента процентами процентов
процесс: процесс процесса процессе процессу процессы
процессуальный: процессуальные
процитировать: процитировав процитировало
прочее: прочего
прочий: прочих
прочный: прочного прочном прочный
прошедшее: прошедшие
прошедший: прошедшую
прошлогодний: прошлогоднего прошлогодней
прошлое: прошлого
прошлый: прошлой прошлом прошлую прошлые прошлый
прощать: прощать
проявление: проявление проявлений проявлению
проявлять: проявляет проявлять
проявляться: проявляются
прямо: прямо
прямой: прямого прямое прямой прямому прямые прямым прямых
прятаться: прячась прячутся
психиатрический: психиатрической
психический: психического психическое психическом психическую
психолог: психологом
психологический: психологическая психологические психологической психологическую
психосоциальный: психосоциальной психосоциальную
птица: птиц птицы
птичий: птичий
публикация: публикации публикацию публикация
публиковать: публикует
публицист: публицист
публично: публично
публичный: публичное
пункт: пункт пункта пунктам пунктах пункте пунктов пунктом пункту пункты
пусто: пусто
пустой: пусты
пустынный: пустынной
пустыня: пустыню
пусть: пусть
путь: пути путь
путём: путем
пушка: пушки
пшеничный: пшеничная пшеничной пшеничную
пытать: пытали
пытаться: пытаемся пытается пыталась пытался пытаться пытаются пытающиеся
пытка: пыткам пытках пытки пыток
пыточный: пыточные
пятеро: пятеро
пятидневный: пятидневный
пятилетний: пятилетний пятилетняя
пятница: пятница пятницу пятницы
пятничный: пятничного
пятый: пятый
пять: пяти пять
раб: рабе
работа: работ работа работе работу работы
работать: работавшие работаем работает работаете работал работала работали работать работают работающие работающий работающих работая
работник: работника работникам работники работников работником
рабочий: рабочей рабочие рабочих
равенство: равенства равенство
равно: равно
равноправие: равноправие
равноправный: равноправным
равносильный: равносильное равносильны
рада: рады
ради: ради
радикализация: радикализации
радоваться: радоваться
радость: радость радостью
радуан: радуан
раз: раза
разан: разан разана
разбирательство: разбирательства
разбирать: разбирают
разбитый: разбитые
разбиться: разбившимся
разбросать: разбросанных
развалины: развалинами
развенчивать: развенчивает
развернуть: развернула развернули развернутой
развернуться: развернулись
развестись: развелись
развивать: развивать
развиваться: развиваться развиваются
развивающийся: развивающегося развивающиеся развивающимися развивающихся
развитие: развитие развитии развитию развития
развитой: развитыми развитых
развиться: развилась
развод: разводов разводу
развозить: развозят
разворачиваться: разворачивается разворачивающаяся разворачивающейся
развёртывание: развертывание развертыванию
разгар: разгар
разговаривать: разговаривал
разговор: разговора
разгораться: разгорается
разграбить: разграблено разграблены
разгрузка: разгрузка
раздавать: раздавать раздаем раздает раздают
раздать: раздали раздать
раздача: раздача раздачи
разделить: разделено
разделять: разделяющего разделяющей
раздеть: раздели
раздирать: раздираемого
раздробить: раздроблено
разжечь: разжечь
разжигание: разжигание
разжигать: разжигает
различный: различной различные различным различных
разложение: разложения
разлучаться: разлучаться
разлучение: разлучения
разлучить: разлученными разлучены
разменный: разменной
размер: размер размере размеры
разместить: разместить размещенных размещено
размещать: размещает
размещение: размещения
разминирование: разминирование разминировании разминированию
разминировать: разминировать
размножаться: размножаются
разногласие: разногласия разногласиями
разнообразие: разнообразие разнообразии разнообразия
разнообразный: разнообразные
разный: разного разные разных
разобрать: разобрало
разом: разом
разорвать: разорвать
разоружение: разоружению
разочарование: разочарование
разочаровать: разочарованы
разрабатывать: разрабатывать разрабатывая
разрабатываться: разрабатывается
разработать: разработаны разработать
разработка: разработке разработку
разрастание: разрастания
разрешать: разрешают
разрешение: разрешение разрешений разрешения
разрешить: разрешат разрешен разрешено разрешить
разруха: разруха
разрушать: разрушает разрушать разрушают
разрушаться: разрушается разрушаются разрушающиеся
разрушение: разрушение разрушений разрушению разрушения разрушениям разрушениями разрушениях
разрушительный: разрушительного разрушительное разрушительной разрушительны разрушительные разрушительным разрушительными разрушительных
разрушить: разрушен разрушена разрушенного разрушенное разрушенной разрушенному разрушенный разрушенных разрушено разрушены разрушили
разрядка: разрядки
разъяснять: разъясняем
район: район районам районах районе районов районом районы
рак: рака
ракета: ракет ракета ракетами ракеты
ракетный: ракетного ракетном ракетные ракетный ракетным ракетными ракетных
рама: рамы
рамалла: рамалле
рамка: рамках рамки
рамочный: рамочной
ран: ран
рана: рана ранами
ранее: ранее
ранение: ранение ранений ранению ранения ранениям ранениями
раненый: раненые раненым раненых
ранить: ранен ранены ранив
ранка: ранку
ранний: раннего раннем ранних раньше
рано: рано
расизм: расизмом
раскачивать: раскачивает
раскрытие: раскрытия
расмуссный: расмуссен
расовый: расовую
расплачиваться: расплачиваются
расположить: расположенная расположенного расположенной расположенные расположенный расположенных расположены
распоряжение: распоряжения
распределение: распределение распределении распределению распределения
распределительный: распределительных
распределить: распределено распределив распределили распределят
распределять: распределяет распределять распределяющих
распределяться: распределяется
распространение: распространением распространению распространения
распространить: распространенная распространенном распространенную распространенный распространенным распространенными распространенных распространены распространило
распространиться: распространились распространиться распространятся
распространять: распространяет распространяли
распространяться: распространяется распространяться распространяются распространяющиеся
распространённость: распространенности
рассесть: рассел
рассказ: рассказы
рассказать: расскажите рассказал рассказала рассказали рассказаны рассказать
рассказывать: рассказываем рассказывает рассказывали рассказывают
расследование: расследование расследованием расследований расследованию расследования
расследовать: расследовали расследованы расследовать расследует
рассматривать: рассматривает
рассматриваться: рассматриваться
рассмотрение: рассмотрение рассмотрения
рассмотреть: рассмотреть рассмотрит
расстояние: расстояния
расстройство: расстройства
рассчитать: рассчитанными рассчитаны
рассчитывать: рассчитывать
рассылка: рассылку
растение: растений растения
расти: растет расти растут растущая растущего растущее растущей растущем растущие растущий растущими растущих растущую рос росли росло
растительный: растительное
растить: растить
расход: расход расходов расходы
расценить: расценена расценены расценить
расчеловечивать: расчеловечивающих
расчистка: расчистку
расчёт: расчетам расчеты
расширение: расширение расширении расширения
расширить: расширенному расширенные расширенный расширены расширить расширят
расширять: расширяет расширять
расширяться: расширяются расширяющегося
рауль: рауля
раф: рафах
рафах: рафаха рафахе рафаху
рвота: рвота
реабилитация: реабилитацию
реагирование: реагированию реагирования
реагировать: реагировать реагирует реагируют
реакция: реакции реакция
реализация: реализации реализацию реализация
реализовать: реализованной реализовать реализуя
реализоваться: реализуется
реалистичный: реалистичных
реальность: реальности реальность реальностью
реальный: реальное реальный
ребёнок: детей дети детьми детям детях ребенка ребенком ребенку ребенок
революция: революции
регин: регина регины
регион: регион региона регионам регионах регионе регионов региону
региональный: регионального региональную региональные региональный региональными региональных
регистрироваться: регистрируется
регулироваться: регулируется
регулярно: регулярно
регулярный: регулярная регулярной регулярные регулярным регулярными регулярных
реджина: реджина
редкий: редкое реже
редко: редко
редкость: редкость
режим: режим режима
резервуар: резервуары
резкий: резкий резкого резкое резком
резко: резко
резной: резней
резолюция: резолюцией резолюции резолюций резолюцию резолюция резолюциями
резонансный: резонансных
результат: результатам результатами результатах результате результатов результатом результаты
рейд: рейд рейда рейде
река: реки
рекомендация: рекомендации рекомендаций рекомендациями
рекомендовать: рекомендовано рекомендует рекомендуют
реконструкция: реконструкции реконструкцию реконструкция
рекорд: рекорд
рекордный: рекордного рекордное рекордные
религиозный: религиозную религиозные религиозных
ремонт: ремонт ремонта ремонте
репатриант: репатриантов
репрессивный: репрессивной
репрессия: репрессий
репродуктивный: репродуктивному
репутационный: репутационные
респираторный: респираторной респираторные респираторными респираторных
республика: республик республике республики республикой республику
ресторан: ресторане
ресурс: ресурсов ресурсом ресурсы
референдум: референдумы
реформа: реформ реформы
реформирование: реформирование реформирования
реформировать: реформировать
речь: речь
решать: решает решать
решающий: решающего решающее решающий
решение: решение решении решению решения решениям
решительно: решительно
решительный: решительным
решить: решили решить
решиться: решились
рик: рик
риск: риск рисками риски рисков риском риску
риска: рисках риске
рисковать: рискует рискуют рискуя
ритм: ритм
риторика: риторика риторики
ричард: ричард ричарда
рияда: рияд
ркик: ркик
роберт: роберт
ровенский: ровенской
ровесник: ровесников
ровно: ровно
рог: роге
род: роде родом
роддом: роддом роддома
родильный: родильное
родина: родине
родитель: родителей родителем родители родитель родителями
родительство: родительство
родиться: родился
родный: родной родные родными родных
родственник: родственниками родственники родственников
роды: родов роды
рожать: рожающих
рождение: рождение рождением рождению рождения
рождественский: рождественским рождественских рождественское
рождество: рождества рождество рождеством
розмари: розмари
роль: роли роль ролях
роскошь: роскошь
российский: российская российские российский российским российскими российских российского российское российской российскому российскую
россия: россией россии россию россия
рост: рост роста росте ростом росту
рот: рот
роу: роу
рубеж: рубеж рубежом
руденко: руденко
рузибоев: рузибоев
руина: руинах руины
рука: руках руке рукой руку
руководитель: руководителей руководители руководитель
руководство: руководство руководством
руководствоваться: руководствуемся
рукума: рукум
румыния: румынии
русский: русский
рухнуть: рухнувших рухнуть
рушиться: рушиться
рф: рф
рыба: рыб рыбами рыбы
рынок: рынкам рынках рынке рынки рынок
ряд: ряд ряда ряде ряду
рядом: рядом
сад: сад сады
сайгак: сайгака сайгаков
саймон: саймон
сайт: сайте сайтом
сакр: сакр сакра
салим: салим
сам: сама сами самим самого самой самом самому
самарканд: самарканде
самер: самер
саммит: саммит саммите
самоа: самоа
самодельный: самодельных
самозащита: самозащита самозащиту
самолёт: самолет самолета самолетом
самооборона: самообороны
самоотверженность: самоотверженность
самостоятельно: самостоятельно
самостоятельность: самостоятельности самостоятельность
самоубийство: самоубийства
самочувствие: самочувствие
самый: самая самое самую самые самый самым самых
санийл: санийла
санитария: санитарии
санитарный: санитарная санитарные санитарными санитарных
саркис: саркис
саттертвейт: саттертвейт
сахарный: сахарный
сб: сб
сбежать: сбегут сбежала
сбой: сбои
сбор: сбор сбора сборах сбором
сбр: сбр
сведение: сведению
сверхурочный: сверхурочной
свет: свет света
свидетель: свидетелем свидетелями
свидетельство: свидетельства свидетельством
свидетельствовать: свидетельствует свидетельствуют
свидетельствующий: свидетельствующие
свирепствовать: свирепствует
сво: сво
свобода: свобод свобода свободу свободы
свободно: свободно
свободный: свободными
свод: свод
своевременно: своевременно
своевременный: своевременную
свой: свое своего своей своем свои своим своими своих свой
сворачивание: сворачивания
сворачивать: сворачивает сворачивать
связанный: связанные связанными связанных
связать: связан связано
связаться: связаться
связующий: связующее
связь: связи связь связям связями связях
святой: святого
священный: священна
сговор: сговор сговоре
сделать: сделаем сделал сделала сделали сделало сделан сделана сделанных сделано сделаны сделать сделают
сдержанность: сдержанность
сдержать: сдержать
сдерживать: сдерживающим
себя: собой
север: север севера севере севером северу
северказказский: северказказских
северный: северная северного северное северной северном северную северные северный северных
северокавказский: северокавказских
сегодня: сегодня
сегодняшний: сегодняшнее сегодняшнем сегодняшние сегодняшний сегодняшним
седа: седы
седой: седа
сезон: сезон сезона
сей: сих
секетарь: секетарь
секретарь: секретарем секретарь секретарю секретаря
секретный: секретного секретных
сексуальный: сексуального сексуальное сексуальном сексуальному
сектор: сектор сектора секторах секторе сектором сектору
секунда: секунду
селиться: селятся
село: село
сельский: сельского сельскому
сельскохозяйственный: сельскохозяйственная сельскохозяйственные сельскохозяйственных
семейный: семейной семейном семейные семейных
семь: семи семь
семья: семей семье семьей семьи семью семья семьям семьями семьях
сенегал: сенегал
сентябрь: сентябре сентября
сепаратистский: сепаратистским
сербия: сербии
сервис: сервисам
сергей: сергеем сергей
сердце: сердца сердце сердцем
сердцебиение: сердцебиение
середина: середине середины
сериал: сериале
серия: серией серии серию серия
серф: серф
серьёзно: серьезно
серьёзность: серьезностью
серьёзный: серьезная серьезнейшая серьезнейшие серьезного серьезное серьезной серьезную серьезные серьезный серьезным серьезных
сесилия: сесилия
сессия: сессии
сестра: сестры
сесть: сел сесть
сеть: сетей сети сетям сетях
сечение: сечение
сеять: сеять
сжечь: сожжены
сигнал: сигнала сигналом сигналы
сидеть: сидит
сила: сил сила силами силах силой силу силы
силовик: силовикам
сильерс: сильерс сильерсом
сильно: сильно
сильный: сильная сильного сильное сильной сильном сильную сильные сильным
сим: сима
символ: символ
символический: символическую
символичный: символичное символичный
симптом: симптом симптомов симптомы
синагога: синагоги синагогу
сингха: сингх
синди: синди
синий: синие
сирена: сирен
сириец: сирийцев
сирийский: сирийское сирийской
сирия: сирии сирию сирия
система: систем система системам системе системой систему системы
систематический: систематические
системный: системную системным
ситуация: ситуацией ситуации ситуаций ситуацию ситуация ситуациям ситуациях
ск: ск
сказать: сказал сказала сказали сказать
сказаться: сказалось сказаться
сказка: сказку
сказываться: сказываться
скамья: скамьи
скапливаться: скапливаются
скат: скатов
скважина: скважин
склад: складах складе складов склады
складываться: складывается складываются
скованность: скованность
сколько: сколько
сконцентрировать: сконцентрирована
скончаться: скончалась скончались скончался
скоординировать: скоординированного скоординированные скоординированных скоординировать
скопиться: скопилось
скорбеть: скорбим скорбят
скорбь: скорбь
скорее: скорее
скоро: скоро
скорость: скорость
скорый: скорой
скот: скота
скотоводческий: скотоводческих
скрываться: скрывающимися
скудный: скудные
скученно: скученно
скученность: скученности скученность
слабо: слабо
следить: следим следит следите следить следят
следователь: следователям
следовать: следует
следственный: следственную следственные следственный следственным
следующий: следующего следующей следующем следующие следующий следующим
слежение: слежения
слезиться: слезящихся
слишком: слишком
словакия: словакии
словения: словенией
словно: словно
слово: слов слова словам словами словах
словосочетание: словосочетание
сложиться: сложившаяся сложившейся сложившихся сложившуюся сложилась сложились
сложно: сложно
сложность: сложности сложность
сложный: сложнее сложнейший сложной сложную сложные сложный сложным сложных
слой: слоев слоям
сломать: сломанные
служащий: служащие служащих
служба: служб служба службами службах службе службу службы
служебный: служебных
служить: служить
слух: слуха
случай: случае случаев случаи случай случая случаями случаях
случиться: случившегося случившемся случилась случилось случись случиться
слушание: слушаний слушания слушаниях
слышать: слышал слышала слышат слышать слышим
слышный: слышен слышны
смартфон: смартфон
смена: смены
смертельно: смертельно
смертельный: смертельная смертельной
смертность: смертности смертность
смертный: смертным
смертоносный: смертоносно смертоносного смертоносной смертоносные смертоносным смертоносных
смерть: смертей смерти смерть
смех: смех
сми: сми
смотреть: смотрела
смочь: смог смогла смогли смогут сможем сможет
смывать: смывают
смысл: смыслах
смягчить: смягчить
снабжать: снабжать
снабжение: снабжение снабжением снабжения
снаружи: снаружи
снаряд: снаряды
снг: снг
снег: снегами
снежный: снежного
снижение: снижение снижения
снизить: снизить
снизиться: снизился
снимать: снимают
снимок: снимках снимки
снова: снова
снять: снял сняты снять
собирать: собирает
собираться: собираемся собирались собирался
соблюдать: соблюдать
соблюдаться: соблюдается соблюдаются
соблюдение: соблюдение соблюдения
соболезнование: соболезнования
собрание: собраний
собрать: собрал собрать
собраться: соберется собравшимся собрался
собственный: собственное собственной собственном собственную собственных
событие: событием событий события событиям событиями событиях
совбез: совбез совбеза совбезе совбезу
совершать: совершает совершал совершающие
совершаться: совершается совершались совершалось совершаются
совершение: совершению совершения
совершенно: совершенно
совершенный: совершенное совершенные совершенный совершенным совершенных
совершенствование: совершенствованию
совершить: совершено
совет: совет совета совете советом совету
совместимый: совместима
совместно: совместно
совместный: совместная совместной совместном совместному совместную совместный совместным совместных
совокупность: совокупности
современный: современной современным
согласие: согласии
согласиться: согласились
согласно: согласно
согласный: согласен согласны
согласование: согласованию согласования
согласовать: согласовало согласован
согласовывать: согласовывала
соглашение: соглашение соглашением соглашении соглашению соглашения
согреться: согреться
содействие: содействие содействии
содействовать: содействовать
содержание: содержание содержания
содержать: содержал содержали содержащих содержит
содержаться: содержавшихся содержался содержаться содержащимися содержится
соединить: соединенного соединенные соединенных
соединять: соединяющих
сожаление: сожаление сожалению
созвать: созвал созвали созван
создавать: создаем создает создают
создание: создание созданием создании созданию создания
создать: создал создало создана созданной созданными создано созданы создать
создаться: создавшейся создавшихся
сознание: сознания
соизмеримый: соизмеримых
сократить: сократить
сократиться: сократилась сократились сократилось
сокращать: сокращает
сокращаться: сокращается сокращаются
сокращение: сокращение сокращением сокращению сокращения
сокрушительный: сокрушительным
солдат: солдат солдата солдатами
солидарность: солидарности солидарность
солнечный: солнечные солнечных
соломенский: соломенский
солончак: солончаки
солтмарш: солтмарш
солёный: соленой
сомали: сомали
сомнение: сомнению сомнения
соображение: соображений соображениям соображениями
сообща: сообща
сообщать: сообщает сообщают
сообщаться: сообщается сообщалось
сообщение: сообщение сообщением сообщении сообщений сообщению сообщения сообщениям сообщениями
сообщество: сообществ сообщества сообществам сообществами сообществах сообществе сообщество сообществу
сообщить: сообщил сообщила сообщили сообщило
сооружение: сооружений сооружения сооружениях
сооснователь: сооснователями
соответственно: соответственно
соответствие: соответствие соответствии
соответствовать: соответствовали соответствовать соответствует соответствуют соответствующий соответствующую
соответствующий: соответствующего соответствующие соответствующими соответствующих
сопровождать: сопровождали сопровождающими сопровождающих
сопровождаться: сопровождается сопровождалось сопровождаться
сопровождение: сопровождения
сопротивление: сопротивления
сопротивляться: сопротивляющимися
сопрячь: сопряжена
сопутствовать: сопутствующий
сор: сор
сосед: соседей соседом соседям соседями
соседний: соседнее соседней соседнем соседние соседний соседних соседнюю
сосредотачиваться: сосредотачиваемся
сосредоточить: сосредоточен сосредоточена сосредоточено сосредоточить
сосредоточиться: сосредоточиться
составить: составил составили составило составит составят
составлять: составляет составлял составляло составляют составляющая составляющей составляя
состояние: состояние состоянием состоянии состоянию
состоять: состоящая
состояться: состоится состоявшихся состоялся
сострадание: сострадания
сосуществование: сосуществование сосуществовании сосуществования
сотня: сотен сотни сотням сотнями сотнях
сотрудник: сотрудник сотрудника сотрудникам сотрудниками сотрудниках сотруднике сотрудники сотрудников
сотрудница: сотрудница сотрудницей сотрудницы
сотрудничать: сотрудничаем сотрудничает сотрудничали сотрудничающие
сотрудничество: сотрудничестве сотрудничество
сотрясать: сотрясает
сохранение: сохранение сохранении сохранению сохранения
сохранить: сохранить
сохранять: сохраняет сохранять
сохраняться: сохраняется сохраняются
соцзащита: соцзащиты
социализация: социализации
социальный: социальной социальную социальные социальным социальных
соцсеть: соцсети соцсетях
сочетание: сочетание сочетании
союз: союза
союзный: союзные союзным союзных
спад: спад спада
спальная: спальные
спасатель: спасатели
спасательный: спасательный спасательным
спасать: спасает спасают
спасаться: спасались спасающихся спасаясь
спасение: спасение спасению спасения
спасти: спасем спасла спасти
спасть: спали
спать: спать спят спящими
спецдокладчик: спецдокладчик спецдокладчика спецдокладчикам спецдокладчики спецдокладчиков
спецдокладчица: спецдокладчица
специализировать: специализированными
специализироваться: специализируется специализирующихся
специалист: специалист специалистов специалисты
специалистка: специалистка
специальный: специальная специального специальные специальный специальных
спецпосланник: спецпосланник
спецпредставитель: спецпредставитель
спинной: спинного
список: списком список
сплотить: сплочены
сплошной: сплошное
спокойный: спокойнее
спор: споры
спорный: спорные
спорт: спорта
способ: способ
способность: способность
способный: способен способна способно способны способными способных
способствовать: способствовать способствуют способствующие способствующих
справедливость: справедливости справедливость
справедливый: справедливого справедливом справедливый справедливым
справиться: справимся справиться
справляться: справляется справляться справляются
спрашивать: спрашивали спрашивают
спровоцировать: спровоцировавшие спровоцированной спровоцированы спровоцировать
спустя: спустя
спутниковый: спутниковые спутниковый спутниковых
сравнение: сравнений сравнению сравнения
сравнимый: сравнимый
сравнять: сравнены сравнял
сражаться: сражаются
сразу: сразу
среда: среда среде среду среды
среди: среди
средиземноморье: средиземноморья
средиземный: средиземном
среднее: среднего среднем
среднемесячный: среднемесячный
среднесуточный: среднесуточного
средний: средний
средство: средств средства средствам средство
срок: срок срока срокам сроках сроки сроков
срочно: срочно
срочный: срочное срочной срочном срочному срочную срочные срочным срочных
ссылаться: ссылается ссылаясь
ссылка: ссылкой
стабильно: стабильно
стабильность: стабильность
стабильный: стабильной
ставить: ставит ставить ставят
сталкивать: сталкивают
сталкиваться: сталкиваемся сталкивается сталкивалась сталкивались сталкиваться сталкиваются сталкивающихся
стандарт: стандартам стандартами стандартах стандартов
становиться: становится становиться становятся
станция: станции станций станция станциях
стараться: стараемся старался стараюсь стараются
старенький: старенькая
старик: старикам старики
стартовать: стартовала стартует
старший: старшего
статистика: статистикой статистику
статистический: статистического
статус: статуса статусе
стать: ставших стал стала стали стало станет стать
статья: статье статьей статьи статью
сташковы: сташков
стекло: стекло
стена: стен стенах
стенограмма: стенограммы
степень: степени
степной: степной
стервятник: стервятник
стереотип: стереотип стереотипов
стефан: стефан
стигматизация: стигматизации
стилл: стилл стилла
стимулировать: стимулировать
стимуляция: стимуляция
стипендия: стипендию
стихийный: стихийного стихийными
сто: ста сто
стоимость: стоимость
стоить: стоило стоит стоить
стойкость: стойкости стойкость
сток: стоки
стол: стол
столетие: столетия
столица: столица столице столицу столицы
столкновение: столкновений столкновения столкновениях
столкнуться: столкнувшаяся столкнувшихся столкнулись столкнулось столкнулся столкнуться
столь: столь
столько: стольких
стонать: стонут
сторона: сторон сторона сторонам сторонами стороне сторону стороны
сторонник: сторонников
сточный: сточными сточных
стоять: стоял стоят
стоящий: стоящих
страдание: страдание страданий страдания страданиям страданиями страданиях
страдать: страдает страдать страдают страдающему страдающих страдая
стража: стражей
страна: стран страна странам странами странах стране страну страны
страница: странице
страничка: страничке
страновой: страновой
стратегический: стратегические
стратегия: стратегии стратегий
страх: страх страха страхе страхом
страшно: страшно
страшный: страшные страшных
стремительно: стремительно
стремительный: стремительное стремительным
стремиться: стремимся стремится стремиться стремясь стремятся
стремление: стремление стремления
стресс: стресса
строгий: строгие
строго: строго
строительный: строительного строительные строительных
строительство: строительстве строительство
строить: строить строят
строиться: строятся
строй: строя
струйка: струйка
структура: структур структуры
стыд: стыд
стёртый: стерто
суббота: субботу субботы
субботний: субботнего
субсидия: субсидий
субъект: субъектах
суверенный: суверенных
суд: суд суда судам суде судом
судан: судан судана судане судану
суданец: суданцам суданцев
суданский: суданская суданские суданским суданскими суданских суданского суданское суданской суданском
судебный: судебного судебной судебные
судить: судя
судьба: судьбе судьбой судьбы
судья: судей судьи судья
сужение: сужение
сулейманов: сулеймановой
султан: султана
султанат: султанатом
сумма: сумме сумму суммы
сумский: сумской
супруг: супругу
суровый: суровой суровые суровым суровыми суровых
сустав: суставах
сутки: сутки суток
суть: сути
сухопутный: сухопутные
суша: суше
сушить: суши
существенно: существенно
существенный: существенное существенной существенные
существование: существовании существованию существования
существовать: существовавшего существовавшему существовать существует существуют
существующий: существующие
сфера: сферам сфере сферу сферы
сходу: сходу
сцена: сцены
сценарий: сценариев сценарии сценарию
счастие: счастьем счастью
счастливый: счастлив счастливы счастливые счастливым счастливых
считать: считаем считает считанные считаю считают
считаться: считались считался считаются
счёт: счет счету
сша: сша
съедать: съедают
сыграть: сыграла сыграли сыграть
сын: сын сына сыновей сыновья сыном
сыпь: сыпи сыпь сыпью
сырой: сырые сырых
сырость: сырости
сырьевой: сырьевые
сюда: сюда
сюжет: сюжет сюжеты
сюрприз: сюрпризов
таблетка: таблетки
таджикистан: таджикистана таджикистане
также: также
такой: такая такие таким такими таких такого такое таком такому такую
тактика: тактики тактику
талеб: талеб
тамара: тамары
тарик: тарик
татьяна: татьяна
тащить: тащат
таять: тает
твиттер: твиттер
твой: твой
творческий: творческой
твёрдо: твердо
твёрдый: твердое
тед: тед
тедроса: тедрос тедроса
тезис: тезисы
текст: текст тексте
текущий: текущем текущий текущих
телеграмма: телеграмм
тележка: тележки
телеканал: телеканалу
телекоммуникационный: телекоммуникационное
телекоммуникация: телекоммуникации телекоммуникаций телекоммуникациях
телемисова: телемисов
телефон: телефону
телефонный: телефонной
тело: тел тела
тема: теме тему темы
тематический: тематических
темп: темпах темпы
температура: температур температура температурой температуры
тенденция: тенденции тенденция тенденциях
тепло: тепла теплом
теракт: теракт терактах терактов теракты
терапия: терапии
тереза: тереза
термоодеяло: термоодеяла
тернопольский: тернопольской
терпеть: терпеть терпят
терпимость: терпимость
территориальный: территориальную территориальными
территория: территории территорий территорию территория территориях
террор: террора
терроризм: терроризма
террорист: террористами террористов
террористический: террористических террористического террористической
терять: терять теряют
тесниться: теснится теснятся
тесно: тесно
теснота: теснота
тесный: тесной
техника: технику
технический: технической
технология: технологии технологий технологиям технологиями
течение: течение
тигр: тигры
тип: типом
тихий: тихая тихого
тлаленг: тлаленг
тоба: тобы
товар: товарами товаров товары
токсичный: токсичных
толика: толикой
толпа: толпы
толчок: толчках толчков
томас: томас томаса
тон: тонах
тонна: тонн
тоннель: тоннеле
топливо: топлива топливе топливо топливом топливу
тор: тор
торговля: торговле торговлей торговли торговлю
торговый: торговой
торецк: торецке
тот: те теми тех той тому
точечный: точечную
точка: точках точки
точный: точное
тошнота: тошнота
травма: травм травма травмами травмах травмой травму травмы
травматологический: травматологической
травмированный: травмированные
травмировать: травмировано травмированы
трагедия: трагедией трагедии трагедия
трагический: трагические трагическим трагических трагического трагическое трагической трагическом трагическую
трагичный: трагичное
традиционный: традиционные традиционных
традиция: традиций
траектория: траекторию
трансграничный: трансграничные
транспорт: транспорта транспортом
транспортировка: транспортировка транспортировки транспортировку
транспортный: транспортного транспортной транспортные транспортный
трансферт: трансферты
тратиться: тратятся
траурный: траурной
требование: требование требований требованиями
требовать: требовали требовать требуем требует требуют требующего требующую
требоваться: требовалось требуется
тревога: тревоги тревогой тревогу
тревожный: тревожная тревожное тревожной тревожную тревожные тревожный тревожных
трек: трека
третий: третий третье третьего третьи третьих
треть: третей трети треть
трехчасовой: трехчасовую
трещать: трещат трещит
три: трем тремя трех
триллион: триллионов
триместр: триместра
триста: триста
трое: трое троих
тройной: тройная тройной
тропический: тропических
тросселла: тросселл
троссесть: троссел
тротуар: тротуары
труба: трубах трубы
трубопровод: трубопроводов
труд: труд трудом
трудно: трудно
труднодоступный: труднодоступные
трудность: трудностей трудности трудностями трудностях
трудный: труднее
трудовой: трудовом трудовые
трудолюбие: трудолюбие
трудоустроить: трудоустроены
трудоустройство: трудоустройства трудоустройству
трёхдневный: трехдневного
трёхлетний: трехлетний
туалет: туалет туалетом туалеты
туберкулёз: туберкулез
туда: туда
тум: тума
тупик: тупик тупике
турбина: турбин
туризм: туризма
туркменистан: туркменистана туркменистане
турция: турцией турции турцию турция
тщательно: тщательно
тщательный: тщательного тщательное тщательной
тысяча: тысяч тысяча тысячам тысячами тысячи
тюремный: тюремного тюремному тюремные тюремный тюремных
тюрк: тюрк
тюрьма: тюрем тюрьмах тюрьме тюрьмы
тяжело: тяжело
тяжелобольной: тяжелобольного
тяжесть: тяжести тяжесть
тяжёлый: тяжелая тяжелее тяжелейший тяжелейших тяжелое тяжелой тяжелом тяжелую тяжелые тяжелый тяжелым тяжелыми тяжелых
тёплый: теплой теплые теплых
тётя: тетя
уайт: уайт уайта
убедительный: убедительным убедительных
убедить: убедить
убедиться: убедился
убеждение: убеждений
убеждённый: убежден
убежище: убежищ убежища убежищами убежищах убежище убежищу
убивать: убивали убивать убивают
убийство: убийств убийства убийствам убийствами убийствах убийство убийству
убито: убито
убитый: убитого убитой убитом убитые убитых
убить: убив убили убит убиты убить убьют
убрать: уберите
уважать: уважал уважали уважать уважают
уважение: уважение
уведомить: уведомили
увезти: увезли
увеличение: увеличение увеличении увеличению увеличения
увеличивать: увеличивает увеличивают
увеличиваться: увеличиваться увеличиваются
увеличить: увеличил увеличила увеличило увеличит увеличить
увеличиться: увеличившемся увеличилась увеличились увеличилось увеличился увеличиться
уверенность: уверенности
уверенный: уверен увереннее
уверить: уверена
увидеть: увиденным увидим
увкб: увкб
увкпча: увкпч
уволить: уволены
увольнение: увольнении
углерод: углерод углерода
углубить: углубят
углублять: углубляет
углубляться: углубляется углубляющийся
угнетение: угнетений
угодный: угодно
угодье: угодья
угол: углы
уголовный: уголовного уголовный уголовным
уголь: угля
угольный: угольная
угрожать: угрожает угрожают угрожающему угрожающие угрожающими
угроза: угроз угроза угрозам угрозами угрозе угрозой угрозу угрозы
удаваться: удается
удалённость: удаленность
удар: удар удара ударам ударами ударах ударе ударов ударом удары
удаться: удалось удастся
удвоить: удвоить
удвоиться: удвоилось
уделить: уделено
уделять: уделяет уделять
уделяться: уделяется уделяться
удержаться: удержаться
удерживать: удерживаемые удерживаемым удерживаемых удерживают
удерживаться: удерживаются
удивительно: удивительно
удивление: удивлением
удобство: удобств
удовлетворение: удовлетворению удовлетворения
удовлетворить: удовлетворим удовлетворить
удостовериться: удостовериться
удушать: удушающей удушающих
уезжать: уезжать
ужас: ужаса ужасе ужасов
ужасать: ужасают
ужасающий: ужасающая ужасающее ужасающей ужасающие ужасающим ужасающих ужасающую
ужасный: ужасна ужасная ужасного ужасной ужасную ужасны ужасных
ужесточение: ужесточение ужесточении ужесточения
ужесточить: ужесточено
узбекистан: узбекистан узбекистана узбекистане
узген: узген
узгенский: узгенской
узнать: узнал
уйти: уйдут уйти ушедшим ушла ушли
указатель: указатель
указать: указаны
указывать: указывает указывать указывают указывающие
уквб: уквб
укгть: укгв
уклад: уклада
укладывать: укладывая
укол: укола
уколоть: уколов
украина: украина украине украиной украину украины
украинец: украинцам украинцев украинцы
украинский: украинская украинские украинским украинскими украинских украинского украинское украинской украинскому украинскую
укрепить: укрепить
укрепление: укрепления
укреплять: укрепляет укреплять
укрываться: укрывается укрывались укрываться укрываются укрывающиеся укрывающимся укрывающихся
укрытие: укрытий укрытия укрытиях
укрыться: укрыться
улица: улиц улицах улице улицы
уличный: уличного
улучшаться: улучшалась
улучшение: улучшение улучшении улучшению улучшения
улучшить: улучшить
улыбаться: улыбаемся улыбаться
уменьшаться: уменьшающимися
уменьшить: уменьшить
умереть: умер умереть умерли умрет умрут
умирать: умирает умирали умирать умирают
умирающий: умирающих
умоляющий: умоляющими
умственный: умственное
умышленный: умышленное умышленному умышленными
унести: унес унесла унесли унесшей
университет: университет университета университете
унижать: унижающим
унижение: унижениями
уничтожение: уничтожение
уничтожить: уничтожено уничтожены уничтожить
упасть: упала упали
упоминание: упоминание упоминания
упоминать: упоминать
упоминаться: упоминается
упомянуть: упомянули упомянут упомянутые
упорство: упорство
употребление: употреблению употребления
управление: управление управлением управлении управления
управляемый: управляемом управляемым
управлять: управлять управляющего
упустить: упустить
урегулирование: урегулированию
урегулировать: урегулировать
уровень: уровень уровне уровнем уровню уровня уровнях
урожай: урожая
усвна: усвн
усиление: усиление усилению усиления
усиленный: усиленной усиленных
усиливать: усиливает
усиливаться: усиливается усиливающийся
усилие: усилий усилия усилиям усилиях
усилить: усилит усилить
усилиться: усилились
ускорение: ускорения
ускорить: ускорила ускорить ускорят
ускориться: ускорилась
условие: условии условий условия условиями условиях
усложнять: усложняет усложняют
услуга: услуг услугам услугами услугах услуги
услышать: услышала услышали услышан услышана услышанными услышаны услышать
успеваемость: успеваемостью
успевать: успеваем
успеть: успели
успех: успеха
успешно: успешно
успешный: успешная успешны успешных
устав: устава уставом уставу
уставать: устаю
установить: установить установлен
установка: установке установок
установление: установлением
установленный: установленных
устаревший: устаревшей
устать: устал
устой: устои
устойчивость: устойчивость
устойчивый: устойчивого устойчивой устойчивому устойчивым
устранение: устранением
устранить: устранить устранят
устранять: устранять
устройство: устройств
усугубить: усугубила усугубило усугубить
усугубиться: усугубилась усугубились
усугублять: усугубляет усугубляют
усугубляться: усугубляется усугубляются усугубляющегося усугубляющимися
утварь: утварь
утвердиться: утвердились
утверждать: утверждает утверждают
утверждаться: утверждается
утверждение: утверждение утверждений утверждения утверждениями
утеплять: утеплять
утешать: утешая
утилизация: утилизации утилизацию
уточнить: уточнила
уточнять: уточняют
утрата: утрата утрату утраты
утро: утра
утроить: утроить
утром: утром
ухаживать: ухаживать ухаживают
ухо: ухом
уход: уход ухода уходу
уходить: уходили уходят
ухудшать: ухудшает
ухудшаться: ухудшается ухудшаться ухудшающаяся ухудшающейся ухудшающихся
ухудшение: ухудшение ухудшением ухудшению ухудшения
ухудшиться: ухудшилась ухудшится ухудшиться
участвовать: участвовали участвовать участвуем участвует участвуют участвующим
участие: участие участием участии участию участия
участиться: участившимися участились
участник: участник участникам участники участников
участок: участках участки участков
участь: участи участь
учащённый: учащенное
учебный: учебного учебном учебный учебных
учесть: учтены
учитель: учителей
учитывать: учитывают учитывающей учитывая
учить: учит учить
учиться: учащихся училась учились учиться
учредить: учреждена
учреждать: учреждает
учреждение: учреждение учреждении учреждений учреждения учреждениям учреждениях
учёба: учебе учебу
учёный: ученых
учёт: учетом
ущемляться: ущемляются
ущерб: ущерб ущерба
уязвимый: уязвимое уязвимой уязвимому уязвимы уязвимые уязвимым уязвимыми уязвимых
фаза: фаз фаза
факт: факт фактов факты
фактически: фактически
фактор: фактор фактора факторов фактором факторы
фао: фао
фауна: фауны
фахед: фахед
февраль: феврале февраль февраля
февральский: февральские
федеральный: федеральная федеральной федеральному федеральные федеральных
федерация: федерацией федерации федерацию
фейсбук: фейсбук
фелипа: фелипе
фельдмана: фельдмана
фермер: фермера фермерам
фермерский: фермерского
физически: физически
физический: физические физическим физического
фиксатор: фиксаторами
фиксировать: фиксировать
фиксироваться: фиксировалось
филипп: филипп филиппа филиппов филиппом
филиппо: филиппо
финальный: финальному
финансирование: финансирование финансированием финансированию финансирования
финансировать: финансируемые
финансироваться: финансируется
финансовый: финансовая финансовое финансовой финансовые финансовых
финишный: финишной
флаг: флаг флаги флагом
фламинго: фламинго
флора: флоры
флоренсия: флоренсия
фолка: фолка
фолькер: фолькер
фон: фона фоне
фонд: фонд фонда фонде фондом фонду
форма: форм формам формами форме формой форму
формальный: формальное
формат: формате
формула: формула формулу
формулировать: формулировать
форум: форума
фото: фото
фотография: фотографии фотографиях
фоторепортаж: фоторепортажи
фрагментация: фрагментации
фраза: фраза
франция: францией франции францию франция
французский: французской
франческа: франческа
френкель: френкель
фронт: фронта
фрукт: фрукты
фсин: фсин
фундаментальный: фундаментальная фундаментальные
функциональный: функциональные
функционирование: функционирование
функционировать: функционировать функционирует функционируют функционирующей функционирующем функционирующих
функция: функции
фура: фур
х: х
хаба: хабу
хабов: хабов
хайд: хайд
халед: халед халедом
халида: халидой
хамас: хамас хамаса хамасом
ханаа: ханаа
ханна: ханной
хаос: хаос хаоса
хаотичный: хаотичные
характер: характер характера характере
характерный: характерны
харджито: харджит
харрис: харрис
хартум: хартум хартуме
харьков: харьков харькова харькове
харьковский: харьковская харьковской
хватать: хватает
хватить: хватило хватит
херсон: херсона херсоне
херсонский: херсонская херсонской
хиджаб: хиджаб хиджаба
хирург: хирургов
хирургический: хирургическая хирургические хирургических
хиярь: хияри
хлеб: хлеб хлеба
хлопать: хлопали
хмельницкий: хмельницкой
ход: ходе
ходить: ходил ходить
хозяйственный: хозяйственные
хозяйство: хозяйства хозяйству
холенок: холенков
холера: холерой
холлингворт: холлингворт
холод: холода
холодильный: холодильного холодильных
холодный: холодной холодную холодный холодных
холокост: холокосте
хоронить: хороня
хороший: лучшее лучшем наилучший хорошее хорошие
хоспис: хоспис
хотеть: хотел хотели хотим хотят хочет хочу
хотеться: хотелось
хотя: хотя
хранение: хранения
хранилище: хранилища
хранить: хранит
храниться: хранившихся хранились хранилось храниться
хронический: хроническими хронических
хрустальный: хрустальной
хусейн: хусейн
хуситовый: хуситов
цар: цар
целевой: целевого целевым
целеустремлённость: целеустремленность
целое: целого целое целом
целостность: целостность
целый: целой целому целую целые целый
цель: целей цели цель целью целям целях
цельсий: цельсию цельсия
цена: цена ценой цену цены
ценить: ценил ценит
ценность: ценности
центр: центр центра центре центров центру центры
центральноазиатский: центральноазиатских
центральноафриканский: центральноафриканской центральноафриканскую
центральный: центральная центрального центральное центральной центральном центральную центральные центральный центральных
цепляться: цепляясь
церемония: церемонии церемонию
церковь: церкви
цивилизация: цивилизации
цикл: цикл цикла
циркулировать: циркулировать
цистерна: цистерны
цитировать: цитируя
цифра: цифр цифры
цифровой: цифровой цифровые цифровых
ч: ч
чад: чаде
чадо: чад чада
чайбан: чайбан
час: час часа часов часом
часами: часами
частично: частично
частичный: частичных
частное: частного
частность: частности
частный: частной частном частный частными частных
часто: часто
частый: частые чаще
часть: части часть частью частях
часы: часы
чей: чьи
человек: людей люди людьми людям людях человек человека человеком
человекообразный: человекообразными
человеческий: человеческие человеческими человеческих человеческое человеческой
человечество: человечества человечеством
человечность: человечности человечность
челюсть: челюстью
черевко: черевко
череда: череда
черкасский: черкасской
черниговский: черниговской
чернобыльский: чернобыльской
черновицкий: черновицкой
черногория: черногории
черномордый: черномордая
черта: чертой
чесотка: чесоткой
чествование: чествование
честь: чести
четверг: четверг четверга
четверо: четверо
четверть: четвертей четверти четверть
четвёртый: четвертый
четыре: четыре четырех
четырёхдневный: четырехдневной четырехдневный
четырёхлетний: четырехлетней
чехия: чехии
чеченский: чеченскую
чечня: чечне чечни чечню чечня
чиновник: чиновник чиновниками чиновников
численность: численность
числиться: числятся
число: числа числе число числом числу
чистый: чистой
читать: читайте читают читающей
чихать: чихает
член: член члена членам членами членов членом члены
чреватый: чревато
чрезвычайно: чрезвычайно
чрезвычайный: чрезвычайная чрезвычайной чрезвычайные чрезвычайный чрезвычайным чрезвычайных
чрезмерный: чрезмерная чрезмерное чрезмерной чрезмерные чрезмерный
что: чему
чувствовать: чувствовали чувствовать чувствую чувствуют
чувствоваться: чувствовался чувствуется
чудо: чудо
чудовищный: чудовищные чудовищными
чужеродный: чужеродных
чуткий: чутким
чёрный: черном
чёткий: четкие четкого
чётко: четко
шаг: шаг шага шагам шаги шагом
шалый: шалом
шанс: шанс шансов шансы
шантажировать: шантажируют
шарлотта: шарлотта шарлоттой
шах: шахи
шахта: шахта
шведский: шведская
швейцария: швейцарию
швейцарский: швейцарским
швеция: швеции
шелтер: шелтера
шептать: шепчут
шестилетний: шестилетняя
шестой: шестого шестым
шесть: шести шесть
шея: шее
широкий: широкий широкую
широко: широко
широкомасштабный: широкомасштабной широкомасштабные широкомасштабным
шиф: шифа шифу
шквал: шквал
школа: школ школа школам школами школах школе школу школы
школьник: школьника школьникам
школьный: школьного школьное школьной школьному школьные школьным школьными школьных
шмыгаль: шмыгаль
шмыгаля: шмыгаля
шов: швам
шок: шок шоке шоком
шокировать: шокирован шокирует шокирующим
шон: шон
шпионаж: шпионаже
шписк: шписке
шрапнель: шрапнели шрапнель
штаб: штаб
штайнер: штайнер
штайть: штайем
штат: штата штатах штате штатов штаты
штраф: штрафа
штрафной: штрафного штрафном
штурм: штурм штурму
щадить: щадят
щека: щеки
щит: щита щитов
щитовидный: щитовидной
эвакуация: эвакуацией эвакуации эвакуацию эвакуация
эвакуировать: эвакуировала эвакуировали эвакуирована эвакуированных эвакуировано эвакуированы эвакуировать
эвакуироваться: эвакуироваться
эдвардс: эдвардс
эдди: эдди
эдем: эдем
эзата: эзату
эквадор: эквадор
экзистенциальный: экзистенциальную экзистенциальные экзистенциальными экзистенциальных
экипаж: экипажа
экологичный: экологичнее
экономика: экономика экономиками экономике экономики экономику
экономист: экономист экономисты
экономически: экономически
экономический: экономическая экономические экономический экономических экономического экономическое экономической
экономия: экономии
экосистема: экосистем экосистемах экосистеме экосистемы
эксклюзивный: эксклюзивном
эксперимент: экспериментах
эксперт: эксперт эксперта экспертам экспертами экспертов эксперты
экспертиза: экспертиза экспертизу
эксплуатация: эксплуатации эксплуатация
экспоненциальный: экспоненциальных
экстрадиция: экстрадиции экстрадицию экстрадиция
экстраординарный: экстраординарных
экстремальный: экстремальная экстремальные экстремальных
экстремизм: экстремизм экстремизме
экстренный: экстренного экстренное экстренной экстренном экстренную экстренные экстренный
элдёр: элдер элдера
электрический: электрического
электричество: электричества электричество электричеству
электронный: электронных
электроснабжение: электроснабжение электроснабжения
электростанция: электростанции электростанция электростанциях
электроэнергия: электроэнергии
элементарный: элементарным
элис: элис
эми: эми
эмират: эмиратами эмиратов
эмоциональный: эмоциональным
эмоция: эмоциями
энергетика: энергетики
энергетический: энергетические энергетического энергетической энергетическом энергетическому
энергия: энергией энергии
энергообъект: энергообъекте
энергоснабжение: энергоснабжения
энергоэффективность: энергоэффективность
энн: энн
энцефалит: энцефалиту
эпицентр: эпицентр эпицентра эпицентре
эпический: эпических эпического
эпоха: эпохи эпоху
эпохальный: эпохальное
эра: эра
эрдать: эрдан
эри: эри
эскалация: эскалацией эскалации эскалацию эскалация
эстония: эстонии
этаж: этажа
этап: этап этапе
этапирование: этапирования
этнический: этнические этнических этнической этническому этническую
это: этим это
этот: эта этими этих этому
эфиопия: эфиопии эфиопию
эффект: эффектами эффектом эффекты
эффективно: эффективно
эффективность: эффективности эффективность
эффективный: эффективна эффективной эффективные эффективный
эшелон: эшелона
юар: юар
юг: юг юга юге югом
южноафриканский: южноафриканские
южный: южная южного южной южном южную южные южный южным южных
юнамид: юнамид
юнеп: юнеп
юнеско: юнеско
юнисеф: юнисеф
юнктад: юнктад
юнмас: юнмас
юнфп: юнфпа
юный: юная юных
юридически: юридически
юридический: юридические юридический юридической
юрий: юрий
юрисдикция: юрисдикции
юрист: юриста юристам юристы
юсеф: юсефа
ютиться: ютятся
явление: явление явлением явлений явления
являться: является являлась являлись являются
ядерный: ядерное ядерную ядерных
язык: язык
языковой: языковое
яичный: яичного
яйцо: яиц яйца
якоб: якоб
январь: январе январь января
яндиева: яндиевой
япония: японией япония
яркий: ярким
ясаревич: ясаревич
ясно: ясно
ясный: ясны ясными
яхта: яхте
яшин: яшин яшина
ёмкость: емкости
